County,Vote type,Total ballots,Contest,Ballots cast,Undervotes
Appling,Absentee by Mail,306,Lieutenant Governor,302,4
Appling,Advance in Person,976,Lieutenant Governor,970,6
Appling,Election Day,3122,Lieutenant Governor,3073,49
Appling,Provisional,4,Lieutenant Governor,4,0
Atkinson,Absentee by Mail,68,Lieutenant Governor,66,2
Atkinson,Advance in Person,495,Lieutenant Governor,473,22
Atkinson,Election Day,1058,Lieutenant Governor,1010,48
Atkinson,Provisional,7,Lieutenant Governor,7,0
Bacon,Absentee by Mail,73,Lieutenant Governor,73,0
Bacon,Advance in Person,887,Lieutenant Governor,864,23
Bacon,Election Day,1240,Lieutenant Governor,1226,14
Bacon,Provisional,3,Lieutenant Governor,3,0
Baker,Absentee by Mail,71,Lieutenant Governor,68,3
Baker,Advance in Person,298,Lieutenant Governor,290,8
Baker,Election Day,617,Lieutenant Governor,596,21
Baker,Provisional,3,Lieutenant Governor,3,0
Baldwin,Absentee by Mail,409,Lieutenant Governor,407,2
Baldwin,Advance in Person,3933,Lieutenant Governor,3892,41
Baldwin,Election Day,6152,Lieutenant Governor,6115,37
Baldwin,Provisional,9,Lieutenant Governor,9,0
Banks,Absentee by Mail,142,Lieutenant Governor,140,2
Banks,Advance in Person,852,Lieutenant Governor,846,6
Banks,Election Day,3339,Lieutenant Governor,3312,27
Banks,Provisional,1,Lieutenant Governor,1,0
Barrow,Absentee by Mail,701,Lieutenant Governor,693,8
Barrow,Advance in Person,4720,Lieutenant Governor,4717,3
Barrow,Election Day,10688,Lieutenant Governor,10637,51
Barrow,Provisional,8,Lieutenant Governor,7,1
Bartow,Absentee by Mail,772,Lieutenant Governor,770,2
Bartow,Advance in Person,5826,Lieutenant Governor,5807,19
Bartow,Election Day,16152,Lieutenant Governor,16036,116
Bartow,Provisional,20,Lieutenant Governor,19,1
Ben Hill,Absentee by Mail,136,Lieutenant Governor,135,1
Ben Hill,Advance in Person,1494,Lieutenant Governor,1463,31
Ben Hill,Election Day,1864,Lieutenant Governor,1858,6
Ben Hill,Provisional,3,Lieutenant Governor,3,0
Berrien,Absentee by Mail,212,Lieutenant Governor,211,1
Berrien,Advance in Person,1103,Lieutenant Governor,1087,16
Berrien,Election Day,2608,Lieutenant Governor,2591,17
Berrien,Provisional,8,Lieutenant Governor,8,0
Bibb,Absentee by Mail,2189,Lieutenant Governor,2166,23
Bibb,Advance in Person,10315,Lieutenant Governor,10157,158
Bibb,Election Day,29989,Lieutenant Governor,29640,349
Bibb,Provisional,78,Lieutenant Governor,76,2
Bleckley,Absentee by Mail,228,Lieutenant Governor,226,2
Bleckley,Advance in Person,1157,Lieutenant Governor,1147,10
Bleckley,Election Day,1855,Lieutenant Governor,1851,4
Bleckley,Provisional,5,Lieutenant Governor,4,1
Brantley,Absentee by Mail,143,Lieutenant Governor,142,1
Brantley,Advance in Person,747,Lieutenant Governor,739,8
Brantley,Election Day,2086,Lieutenant Governor,2078,8
Brantley,Provisional,4,Lieutenant Governor,4,0
Brooks,Absentee by Mail,1016,Lieutenant Governor,1006,10
Brooks,Advance in Person,1259,Lieutenant Governor,1250,9
Brooks,Election Day,2355,Lieutenant Governor,2332,23
Brooks,Provisional,26,Lieutenant Governor,25,1
Bryan,Absentee by Mail,237,Lieutenant Governor,233,4
Bryan,Advance in Person,2852,Lieutenant Governor,2843,9
Bryan,Election Day,4863,Lieutenant Governor,4845,18
Bryan,Provisional,3,Lieutenant Governor,3,0
Bulloch,Absentee by Mail,541,Lieutenant Governor,537,4
Bulloch,Advance in Person,3846,Lieutenant Governor,3835,11
Bulloch,Election Day,9455,Lieutenant Governor,9394,61
Bulloch,Provisional,12,Lieutenant Governor,12,0
Burke,Absentee by Mail,594,Lieutenant Governor,592,2
Burke,Advance in Person,1260,Lieutenant Governor,1247,13
Burke,Election Day,4049,Lieutenant Governor,4006,43
Burke,Provisional,0,Lieutenant Governor,0,0
Butts,Absentee by Mail,183,Lieutenant Governor,181,2
Butts,Advance in Person,3252,Lieutenant Governor,3229,23
Butts,Election Day,2671,Lieutenant Governor,2656,15
Butts,Provisional,0,Lieutenant Governor,0,0
Calhoun,Absentee by Mail,91,Lieutenant Governor,89,2
Calhoun,Advance in Person,320,Lieutenant Governor,317,3
Calhoun,Election Day,1044,Lieutenant Governor,1044,0
Calhoun,Provisional,2,Lieutenant Governor,2,0
Camden,Absentee by Mail,586,Lieutenant Governor,583,3
Camden,Advance in Person,2509,Lieutenant Governor,2501,8
Camden,Election Day,6720,Lieutenant Governor,6684,36
Camden,Provisional,9,Lieutenant Governor,9,0
Candler,Absentee by Mail,108,Lieutenant Governor,108,0
Candler,Advance in Person,835,Lieutenant Governor,834,1
Candler,Election Day,1258,Lieutenant Governor,1255,3
Candler,Provisional,0,Lieutenant Governor,0,0
Carroll,Absentee by Mail,845,Lieutenant Governor,839,6
Carroll,Advance in Person,7673,Lieutenant Governor,7641,32
Carroll,Election Day,17495,Lieutenant Governor,17428,67
Carroll,Provisional,53,Lieutenant Governor,53,0
Catoosa,Absentee by Mail,456,Lieutenant Governor,447,9
Catoosa,Advance in Person,4909,Lieutenant Governor,4843,66
Catoosa,Election Day,8541,Lieutenant Governor,8397,144
Catoosa,Provisional,14,Lieutenant Governor,14,0
Charlton,Absentee by Mail,80,Lieutenant Governor,79,1
Charlton,Advance in Person,684,Lieutenant Governor,683,1
Charlton,Election Day,1247,Lieutenant Governor,1237,10
Charlton,Provisional,4,Lieutenant Governor,4,0
Chatham,Absentee by Mail,2948,Lieutenant Governor,2911,37
Chatham,Advance in Person,17241,Lieutenant Governor,17230,11
Chatham,Election Day,48480,Lieutenant Governor,48390,90
Chatham,Provisional,55,Lieutenant Governor,53,2
Chattahoochee,Absentee by Mail,22,Lieutenant Governor,21,1
Chattahoochee,Advance in Person,196,Lieutenant Governor,194,2
Chattahoochee,Election Day,481,Lieutenant Governor,476,5
Chattahoochee,Provisional,2,Lieutenant Governor,2,0
Chattooga,Absentee by Mail,107,Lieutenant Governor,104,3
Chattooga,Advance in Person,1625,Lieutenant Governor,1588,37
Chattooga,Election Day,3090,Lieutenant Governor,3037,53
Chattooga,Provisional,2,Lieutenant Governor,2,0
Cherokee,Absentee by Mail,2440,Lieutenant Governor,2414,26
Cherokee,Advance in Person,23437,Lieutenant Governor,23263,174
Cherokee,Election Day,40811,Lieutenant Governor,40474,337
Cherokee,Provisional,31,Lieutenant Governor,29,2
Clarke,Absentee by Mail,1152,Lieutenant Governor,1128,24
Clarke,Advance in Person,7332,Lieutenant Governor,7214,118
Clarke,Election Day,16976,Lieutenant Governor,16668,308
Clarke,Provisional,76,Lieutenant Governor,74,2
Clay,Absentee by Mail,90,Lieutenant Governor,90,0
Clay,Advance in Person,244,Lieutenant Governor,240,4
Clay,Election Day,602,Lieutenant Governor,592,10
Clay,Provisional,1,Lieutenant Governor,1,0
Clayton,Absentee by Mail,1772,Lieutenant Governor,1756,16
Clayton,Advance in Person,25878,Lieutenant Governor,25809,69
Clayton,Election Day,34794,Lieutenant Governor,34628,166
Clayton,Provisional,66,Lieutenant Governor,66,0
Clinch,Absentee by Mail,53,Lieutenant Governor,53,0
Clinch,Advance in Person,340,Lieutenant Governor,333,7
Clinch,Election Day,777,Lieutenant Governor,768,9
Clinch,Provisional,2,Lieutenant Governor,2,0
Cobb,Absentee by Mail,10616,Lieutenant Governor,10447,169
Cobb,Advance in Person,58755,Lieutenant Governor,58151,604
Cobb,Election Day,143123,Lieutenant Governor,140677,2446
Cobb,Provisional,581,Lieutenant Governor,566,15
Coffee,Absentee by Mail,328,Lieutenant Governor,327,1
Coffee,Advance in Person,3477,Lieutenant Governor,3465,12
Coffee,Election Day,4390,Lieutenant Governor,4336,54
Coffee,Provisional,7,Lieutenant Governor,7,0
Colquitt,Absentee by Mail,172,Lieutenant Governor,171,1
Colquitt,Advance in Person,2409,Lieutenant Governor,2377,32
Colquitt,Election Day,5359,Lieutenant Governor,5325,34
Colquitt,Provisional,4,Lieutenant Governor,4,0
Columbia,Absentee by Mail,1698,Lieutenant Governor,1687,11
Columbia,Advance in Person,11710,Lieutenant Governor,11710,0
Columbia,Election Day,26403,Lieutenant Governor,26403,0
Columbia,Provisional,10,Lieutenant Governor,10,0
Cook,Absentee by Mail,113,Lieutenant Governor,113,0
Cook,Advance in Person,1115,Lieutenant Governor,1099,16
Cook,Election Day,2316,Lieutenant Governor,2299,17
Cook,Provisional,0,Lieutenant Governor,0,0
Coweta,Absentee by Mail,1733,Lieutenant Governor,1720,13
Coweta,Advance in Person,9167,Lieutenant Governor,9136,31
Coweta,Election Day,26256,Lieutenant Governor,26126,130
Coweta,Provisional,15,Lieutenant Governor,15,0
Crawford,Absentee by Mail,146,Lieutenant Governor,146,0
Crawford,Advance in Person,1092,Lieutenant Governor,1066,26
Crawford,Election Day,2012,Lieutenant Governor,1994,18
Crawford,Provisional,4,Lieutenant Governor,4,0
Crisp,Absentee by Mail,169,Lieutenant Governor,167,2
Crisp,Advance in Person,2060,Lieutenant Governor,2024,36
Crisp,Election Day,2752,Lieutenant Governor,2710,42
Crisp,Provisional,2,Lieutenant Governor,2,0
Dade,Absentee by Mail,114,Lieutenant Governor,109,5
Dade,Advance in Person,1030,Lieutenant Governor,996,34
Dade,Election Day,2283,Lieutenant Governor,2210,73
Dade,Provisional,9,Lieutenant Governor,9,0
Dawson,Absentee by Mail,311,Lieutenant Governor,307,4
Dawson,Advance in Person,3231,Lieutenant Governor,3196,35
Dawson,Election Day,3731,Lieutenant Governor,3702,29
Dawson,Provisional,11,Lieutenant Governor,11,0
DeKalb,Absentee by Mail,8280,Lieutenant Governor,8118,162
DeKalb,Advance in Person,72480,Lieutenant Governor,71949,531
DeKalb,Election Day,129376,Lieutenant Governor,127506,1870
DeKalb,Provisional,503,Lieutenant Governor,493,10
Decatur,Absentee by Mail,269,Lieutenant Governor,267,2
Decatur,Advance in Person,1985,Lieutenant Governor,1961,24
Decatur,Election Day,3820,Lieutenant Governor,3784,36
Decatur,Provisional,5,Lieutenant Governor,5,0
Dodge,Absentee by Mail,219,Lieutenant Governor,217,2
Dodge,Advance in Person,1690,Lieutenant Governor,1644,46
Dodge,Election Day,3173,Lieutenant Governor,3132,41
Dodge,Provisional,0,Lieutenant Governor,0,0
Dooly,Absentee by Mail,68,Lieutenant Governor,68,0
Dooly,Advance in Person,834,Lieutenant Governor,801,33
Dooly,Election Day,1783,Lieutenant Governor,1751,32
Dooly,Provisional,0,Lieutenant Governor,0,0
Dougherty,Absentee by Mail,1050,Lieutenant Governor,1037,13
Dougherty,Advance in Person,6272,Lieutenant Governor,6211,61
Dougherty,Election Day,16148,Lieutenant Governor,16067,81
Dougherty,Provisional,41,Lieutenant Governor,41,0
Douglas,Absentee by Mail,1308,Lieutenant Governor,1298,10
Douglas,Advance in Person,15797,Lieutenant Governor,15757,40
Douglas,Election Day,20398,Lieutenant Governor,20398,0
Douglas,Provisional,27,Lieutenant Governor,27,0
Early,Absentee by Mail,140,Lieutenant Governor,140,0
Early,Advance in Person,890,Lieutenant Governor,876,14
Early,Election Day,2163,Lieutenant Governor,2141,22
Early,Provisional,3,Lieutenant Governor,3,0
Echols,Absentee by Mail,19,Lieutenant Governor,19,0
Echols,Advance in Person,243,Lieutenant Governor,240,3
Echols,Election Day,361,Lieutenant Governor,357,4
Echols,Provisional,0,Lieutenant Governor,0,0
Effingham,Absentee by Mail,373,Lieutenant Governor,371,2
Effingham,Advance in Person,3036,Lieutenant Governor,3030,6
Effingham,Election Day,9204,Lieutenant Governor,9204,0
Effingham,Provisional,10,Lieutenant Governor,9,1
Elbert,Absentee by Mail,219,Lieutenant Governor,218,1
Elbert,Advance in Person,1841,Lieutenant Governor,1808,33
Elbert,Election Day,2632,Lieutenant Governor,2628,4
Elbert,Provisional,11,Lieutenant Governor,10,1
Emanuel,Absentee by Mail,213,Lieutenant Governor,210,3
Emanuel,Advance in Person,1187,Lieutenant Governor,1163,24
Emanuel,Election Day,3581,Lieutenant Governor,3526,55
Emanuel,Provisional,1,Lieutenant Governor,1,0
Evans,Absentee by Mail,122,Lieutenant Governor,122,0
Evans,Advance in Person,921,Lieutenant Governor,916,5
Evans,Election Day,1107,Lieutenant Governor,1104,3
Evans,Provisional,0,Lieutenant Governor,0,0
Fannin,Absentee by Mail,417,Lieutenant Governor,411,6
Fannin,Advance in Person,2268,Lieutenant Governor,2248,20
Fannin,Election Day,4216,Lieutenant Governor,4163,53
Fannin,Provisional,3,Lieutenant Governor,3,0
Fayette,Absentee by Mail,1272,Lieutenant Governor,1260,12
Fayette,Advance in Person,18189,Lieutenant Governor,18067,122
Fayette,Election Day,22606,Lieutenant Governor,22413,193
Fayette,Provisional,13,Lieutenant Governor,13,0
Floyd,Absentee by Mail,771,Lieutenant Governor,761,10
Floyd,Advance in Person,5763,Lieutenant Governor,5755,8
Floyd,Election Day,14210,Lieutenant Governor,14079,131
Floyd,Provisional,78,Lieutenant Governor,76,2
Forsyth,Absentee by Mail,1655,Lieutenant Governor,1624,31
Forsyth,Advance in Person,22647,Lieutenant Governor,22478,169
Forsyth,Election Day,32220,Lieutenant Governor,32003,217
Forsyth,Provisional,48,Lieutenant Governor,46,2
Franklin,Absentee by Mail,198,Lieutenant Governor,194,4
Franklin,Advance in Person,1077,Lieutenant Governor,1064,13
Franklin,Election Day,3454,Lieutenant Governor,3436,18
Franklin,Provisional,1,Lieutenant Governor,1,0
Fulton,Absentee by Mail,8864,Lieutenant Governor,8749,115
Fulton,Advance in Person,87201,Lieutenant Governor,86235,966
Fulton,Election Day,167468,Lieutenant Governor,164912,2556
Fulton,Provisional,2135,Lieutenant Governor,2083,52
Gilmer,Absentee by Mail,378,Lieutenant Governor,377,1
Gilmer,Advance in Person,2578,Lieutenant Governor,2552,26
Gilmer,Election Day,4854,Lieutenant Governor,4797,57
Gilmer,Provisional,16,Lieutenant Governor,15,1
Glascock,Absentee by Mail,36,Lieutenant Governor,35,1
Glascock,Advance in Person,211,Lieutenant Governor,206,5
Glascock,Election Day,542,Lieutenant Governor,538,4
Glascock,Provisional,0,Lieutenant Governor,0,0
Glynn,Absentee by Mail,883,Lieutenant Governor,876,7
Glynn,Advance in Person,7098,Lieutenant Governor,7077,21
Glynn,Election Day,12102,Lieutenant Governor,12057,45
Glynn,Provisional,36,Lieutenant Governor,34,2
Gordon,Absentee by Mail,370,Lieutenant Governor,364,6
Gordon,Advance in Person,2666,Lieutenant Governor,2610,56
Gordon,Election Day,7273,Lieutenant Governor,7154,119
Gordon,Provisional,16,Lieutenant Governor,15,1
Grady,Absentee by Mail,157,Lieutenant Governor,155,2
Grady,Advance in Person,1854,Lieutenant Governor,1817,37
Grady,Election Day,3548,Lieutenant Governor,3523,25
Grady,Provisional,6,Lieutenant Governor,6,0
Greene,Absentee by Mail,538,Lieutenant Governor,534,4
Greene,Advance in Person,3068,Lieutenant Governor,3060,8
Greene,Election Day,2907,Lieutenant Governor,2869,38
Greene,Provisional,10,Lieutenant Governor,10,0
Gwinnett,Absentee by Mail,8170,Lieutenant Governor,8069,101
Gwinnett,Advance in Person,47244,Lieutenant Governor,47022,222
Gwinnett,Election Day,141636,Lieutenant Governor,140563,1073
Gwinnett,Provisional,1155,Lieutenant Governor,1133,22
Habersham,Absentee by Mail,704,Lieutenant Governor,700,4
Habersham,Advance in Person,5381,Lieutenant Governor,5332,49
Habersham,Election Day,3529,Lieutenant Governor,3505,24
Habersham,Provisional,34,Lieutenant Governor,31,3
Hall,Absentee by Mail,2074,Lieutenant Governor,2059,15
Hall,Advance in Person,12299,Lieutenant Governor,12170,129
Hall,Election Day,29428,Lieutenant Governor,29236,192
Hall,Provisional,42,Lieutenant Governor,41,1
Hancock,Absentee by Mail,283,Lieutenant Governor,278,5
Hancock,Advance in Person,839,Lieutenant Governor,813,26
Hancock,Election Day,1257,Lieutenant Governor,1232,25
Hancock,Provisional,19,Lieutenant Governor,16,3
Haralson,Absentee by Mail,262,Lieutenant Governor,261,1
Haralson,Advance in Person,1563,Lieutenant Governor,1552,11
Haralson,Election Day,4986,Lieutenant Governor,4943,43
Haralson,Provisional,2,Lieutenant Governor,2,0
Harris,Absentee by Mail,493,Lieutenant Governor,491,2
Harris,Advance in Person,2950,Lieutenant Governor,2937,13
Harris,Election Day,6803,Lieutenant Governor,6786,17
Harris,Provisional,2,Lieutenant Governor,2,0
Hart,Absentee by Mail,287,Lieutenant Governor,281,6
Hart,Advance in Person,2309,Lieutenant Governor,2261,48
Hart,Election Day,4185,Lieutenant Governor,4159,26
Hart,Provisional,1,Lieutenant Governor,1,0
Heard,Absentee by Mail,157,Lieutenant Governor,154,3
Heard,Advance in Person,552,Lieutenant Governor,538,14
Heard,Election Day,1772,Lieutenant Governor,1765,7
Heard,Provisional,0,Lieutenant Governor,0,0
Henry,Absentee by Mail,2016,Lieutenant Governor,2005,11
Henry,Advance in Person,29231,Lieutenant Governor,29215,16
Henry,Election Day,31732,Lieutenant Governor,31694,38
Henry,Provisional,102,Lieutenant Governor,101,1
Houston,Absentee by Mail,1431,Lieutenant Governor,1414,17
Houston,Advance in Person,16400,Lieutenant Governor,16340,60
Houston,Election Day,19454,Lieutenant Governor,19334,120
Houston,Provisional,62,Lieutenant Governor,58,4
Irwin,Absentee by Mail,61,Lieutenant Governor,61,0
Irwin,Advance in Person,719,Lieutenant Governor,690,29
Irwin,Election Day,1581,Lieutenant Governor,1547,34
Irwin,Provisional,3,Lieutenant Governor,2,1
Jackson,Absentee by Mail,495,Lieutenant Governor,489,6
Jackson,Advance in Person,5419,Lieutenant Governor,5397,22
Jackson,Election Day,10060,Lieutenant Governor,10002,58
Jackson,Provisional,16,Lieutenant Governor,15,1
Jasper,Absentee by Mail,255,Lieutenant Governor,253,2
Jasper,Advance in Person,1280,Lieutenant Governor,1264,16
Jasper,Election Day,2305,Lieutenant Governor,2304,1
Jasper,Provisional,2,Lieutenant Governor,2,0
Jeff Davis,Absentee by Mail,153,Lieutenant Governor,149,4
Jeff Davis,Advance in Person,861,Lieutenant Governor,846,15
Jeff Davis,Election Day,1973,Lieutenant Governor,1938,35
Jeff Davis,Provisional,1,Lieutenant Governor,1,0
Jefferson,Absentee by Mail,216,Lieutenant Governor,213,3
Jefferson,Advance in Person,1158,Lieutenant Governor,1150,8
Jefferson,Election Day,3144,Lieutenant Governor,3100,44
Jefferson,Provisional,20,Lieutenant Governor,20,0
Jenkins,Absentee by Mail,163,Lieutenant Governor,162,1
Jenkins,Advance in Person,671,Lieutenant Governor,665,6
Jenkins,Election Day,1088,Lieutenant Governor,1069,19
Jenkins,Provisional,0,Lieutenant Governor,0,0
Johnson,Absentee by Mail,92,Lieutenant Governor,91,1
Johnson,Advance in Person,789,Lieutenant Governor,769,20
Johnson,Election Day,1415,Lieutenant Governor,1403,12
Johnson,Provisional,0,Lieutenant Governor,0,0
Jones,Absentee by Mail,511,Lieutenant Governor,506,5
Jones,Advance in Person,2913,Lieutenant Governor,2908,5
Jones,Election Day,4638,Lieutenant Governor,4628,10
Jones,Provisional,7,Lieutenant Governor,7,0
Lamar,Absentee by Mail,215,Lieutenant Governor,213,2
Lamar,Advance in Person,1700,Lieutenant Governor,1672,28
Lamar,Election Day,3046,Lieutenant Governor,3041,5
Lamar,Provisional,5,Lieutenant Governor,5,0
Lanier,Absentee by Mail,40,Lieutenant Governor,40,0
Lanier,Advance in Person,521,Lieutenant Governor,508,13
Lanier,Election Day,878,Lieutenant Governor,866,12
Lanier,Provisional,4,Lieutenant Governor,4,0
Laurens,Absentee by Mail,763,Lieutenant Governor,758,5
Laurens,Advance in Person,3953,Lieutenant Governor,3913,40
Laurens,Election Day,8153,Lieutenant Governor,8058,95
Laurens,Provisional,14,Lieutenant Governor,14,0
Lee,Absentee by Mail,241,Lieutenant Governor,241,0
Lee,Advance in Person,2107,Lieutenant Governor,2104,3
Lee,Election Day,6514,Lieutenant Governor,6505,9
Lee,Provisional,5,Lieutenant Governor,5,0
Liberty,Absentee by Mail,209,Lieutenant Governor,207,2
Liberty,Advance in Person,3652,Lieutenant Governor,3626,26
Liberty,Election Day,5097,Lieutenant Governor,5081,16
Liberty,Provisional,4,Lieutenant Governor,4,0
Lincoln,Absentee by Mail,222,Lieutenant Governor,222,0
Lincoln,Advance in Person,899,Lieutenant Governor,890,9
Lincoln,Election Day,1554,Lieutenant Governor,1550,4
Lincoln,Provisional,13,Lieutenant Governor,13,0
Long,Absentee by Mail,40,Lieutenant Governor,40,0
Long,Advance in Person,691,Lieutenant Governor,686,5
Long,Election Day,1397,Lieutenant Governor,1385,12
Long,Provisional,6,Lieutenant Governor,6,0
Lowndes,Absentee by Mail,532,Lieutenant Governor,528,4
Lowndes,Advance in Person,8813,Lieutenant Governor,8787,26
Lowndes,Election Day,11478,Lieutenant Governor,11432,46
Lowndes,Provisional,560,Lieutenant Governor,558,2
Lumpkin,Absentee by Mail,305,Lieutenant Governor,303,2
Lumpkin,Advance in Person,2933,Lieutenant Governor,2927,6
Lumpkin,Election Day,4404,Lieutenant Governor,4379,25
Lumpkin,Provisional,15,Lieutenant Governor,15,0
Macon,Absentee by Mail,106,Lieutenant Governor,106,0
Macon,Advance in Person,1207,Lieutenant Governor,1160,47
Macon,Election Day,1695,Lieutenant Governor,1641,54
Macon,Provisional,0,Lieutenant Governor,0,0
Madison,Absentee by Mail,312,Lieutenant Governor,310,2
Madison,Advance in Person,2257,Lieutenant Governor,2254,3
Madison,Election Day,4970,Lieutenant Governor,4928,42
Madison,Provisional,6,Lieutenant Governor,5,1
Marion,Absentee by Mail,219,Lieutenant Governor,216,3
Marion,Advance in Person,612,Lieutenant Governor,602,10
Marion,Election Day,1314,Lieutenant Governor,1283,31
Marion,Provisional,0,Lieutenant Governor,0,0
McDuffie,Absentee by Mail,351,Lieutenant Governor,349,2
McDuffie,Advance in Person,2043,Lieutenant Governor,2026,17
McDuffie,Election Day,3653,Lieutenant Governor,3628,25
McDuffie,Provisional,3,Lieutenant Governor,2,1
McIntosh,Absentee by Mail,300,Lieutenant Governor,291,9
McIntosh,Advance in Person,1300,Lieutenant Governor,1287,13
McIntosh,Election Day,2233,Lieutenant Governor,2222,11
McIntosh,Provisional,7,Lieutenant Governor,7,0
Meriwether,Absentee by Mail,207,Lieutenant Governor,204,3
Meriwether,Advance in Person,1188,Lieutenant Governor,1171,17
Meriwether,Election Day,4671,Lieutenant Governor,4606,65
Meriwether,Provisional,1,Lieutenant Governor,1,0
Miller,Absentee by Mail,53,Lieutenant Governor,53,0
Miller,Advance in Person,436,Lieutenant Governor,433,3
Miller,Election Day,937,Lieutenant Governor,927,10
Miller,Provisional,1,Lieutenant Governor,1,0
Mitchell,Absentee by Mail,202,Lieutenant Governor,202,0
Mitchell,Advance in Person,1589,Lieutenant Governor,1566,23
Mitchell,Election Day,3215,Lieutenant Governor,3188,27
Mitchell,Provisional,3,Lieutenant Governor,3,0
Monroe,Absentee by Mail,358,Lieutenant Governor,356,2
Monroe,Advance in Person,2523,Lieutenant Governor,2498,25
Monroe,Election Day,5671,Lieutenant Governor,5655,16
Monroe,Provisional,23,Lieutenant Governor,22,1
Montgomery,Absentee by Mail,92,Lieutenant Governor,90,2
Montgomery,Advance in Person,463,Lieutenant Governor,450,13
Montgomery,Election Day,1730,Lieutenant Governor,1700,30
Montgomery,Provisional,0,Lieutenant Governor,0,0
Morgan,Absentee by Mail,193,Lieutenant Governor,193,0
Morgan,Advance in Person,2475,Lieutenant Governor,2471,4
Morgan,Election Day,3635,Lieutenant Governor,3610,25
Morgan,Provisional,7,Lieutenant Governor,7,0
Murray,Absentee by Mail,207,Lieutenant Governor,199,8
Murray,Advance in Person,1347,Lieutenant Governor,1313,34
Murray,Election Day,4497,Lieutenant Governor,4410,87
Murray,Provisional,0,Lieutenant Governor,0,0
Muscogee,Absentee by Mail,2150,Lieutenant Governor,2133,17
Muscogee,Advance in Person,13494,Lieutenant Governor,13321,173
Muscogee,Election Day,25301,Lieutenant Governor,25201,100
Muscogee,Provisional,63,Lieutenant Governor,63,0
Newton,Absentee by Mail,1136,Lieutenant Governor,1124,12
Newton,Advance in Person,10430,Lieutenant Governor,10387,43
Newton,Election Day,16634,Lieutenant Governor,16600,34
Newton,Provisional,2,Lieutenant Governor,2,0
Oconee,Absentee by Mail,368,Lieutenant Governor,360,8
Oconee,Advance in Person,5438,Lieutenant Governor,5368,70
Oconee,Election Day,7726,Lieutenant Governor,7581,145
Oconee,Provisional,7,Lieutenant Governor,6,1
Oglethorpe,Absentee by Mail,217,Lieutenant Governor,217,0
Oglethorpe,Advance in Person,1609,Lieutenant Governor,1598,11
Oglethorpe,Election Day,2262,Lieutenant Governor,2254,8
Oglethorpe,Provisional,4,Lieutenant Governor,4,0
Paulding,Absentee by Mail,1789,Lieutenant Governor,1774,15
Paulding,Advance in Person,14824,Lieutenant Governor,14824,0
Paulding,Election Day,19620,Lieutenant Governor,19607,13
Paulding,Provisional,29,Lieutenant Governor,27,2
Peach,Absentee by Mail,215,Lieutenant Governor,214,1
Peach,Advance in Person,3402,Lieutenant Governor,3380,22
Peach,Election Day,3620,Lieutenant Governor,3610,10
Peach,Provisional,8,Lieutenant Governor,8,0
Pickens,Absentee by Mail,138,Lieutenant Governor,137,1
Pickens,Advance in Person,3653,Lieutenant Governor,3635,18
Pickens,Election Day,5031,Lieutenant Governor,5020,11
Pickens,Provisional,1,Lieutenant Governor,1,0
Pierce,Absentee by Mail,228,Lieutenant Governor,228,0
Pierce,Advance in Person,1629,Lieutenant Governor,1612,17
Pierce,Election Day,2106,Lieutenant Governor,2094,12
Pierce,Provisional,0,Lieutenant Governor,0,0
Pike,Absentee by Mail,246,Lieutenant Governor,243,3
Pike,Advance in Person,1650,Lieutenant Governor,1650,0
Pike,Election Day,3700,Lieutenant Governor,3688,12
Pike,Provisional,8,Lieutenant Governor,7,1
Polk,Absentee by Mail,235,Lieutenant Governor,232,3
Polk,Advance in Person,3214,Lieutenant Governor,3189,25
Polk,Election Day,4537,Lieutenant Governor,4515,22
Polk,Provisional,4,Lieutenant Governor,4,0
Pulaski,Absentee by Mail,86,Lieutenant Governor,85,1
Pulaski,Advance in Person,1249,Lieutenant Governor,1227,22
Pulaski,Election Day,1013,Lieutenant Governor,989,24
Pulaski,Provisional,2,Lieutenant Governor,2,0
Putnam,Absentee by Mail,387,Lieutenant Governor,387,0
Putnam,Advance in Person,2434,Lieutenant Governor,2434,0
Putnam,Election Day,3451,Lieutenant Governor,3437,14
Putnam,Provisional,2,Lieutenant Governor,2,0
Quitman,Absentee by Mail,41,Lieutenant Governor,41,0
Quitman,Advance in Person,209,Lieutenant Governor,203,6
Quitman,Election Day,347,Lieutenant Governor,342,5
Quitman,Provisional,1,Lieutenant Governor,1,0
Rabun,Absentee by Mail,427,Lieutenant Governor,419,8
Rabun,Advance in Person,3295,Lieutenant Governor,3224,71
Rabun,Election Day,1731,Lieutenant Governor,1688,43
Rabun,Provisional,0,Lieutenant Governor,0,0
Randolph,Absentee by Mail,149,Lieutenant Governor,146,3
Randolph,Advance in Person,789,Lieutenant Governor,774,15
Randolph,Election Day,1173,Lieutenant Governor,1161,12
Randolph,Provisional,7,Lieutenant Governor,6,1
Richmond,Absentee by Mail,3207,Lieutenant Governor,3184,23
Richmond,Advance in Person,13314,Lieutenant Governor,13159,155
Richmond,Election Day,31248,Lieutenant Governor,31007,241
Richmond,Provisional,71,Lieutenant Governor,70,1
Rockdale,Absentee by Mail,825,Lieutenant Governor,814,11
Rockdale,Advance in Person,13442,Lieutenant Governor,13397,45
Rockdale,Election Day,12256,Lieutenant Governor,12240,16
Rockdale,Provisional,48,Lieutenant Governor,47,1
Schley,Absentee by Mail,66,Lieutenant Governor,65,1
Schley,Advance in Person,602,Lieutenant Governor,597,5
Schley,Election Day,595,Lieutenant Governor,592,3
Schley,Provisional,3,Lieutenant Governor,3,0
Screven,Absentee by Mail,158,Lieutenant Governor,154,4
Screven,Advance in Person,1201,Lieutenant Governor,1185,16
Screven,Election Day,2412,Lieutenant Governor,2394,18
Screven,Provisional,4,Lieutenant Governor,4,0
Seminole,Absentee by Mail,76,Lieutenant Governor,76,0
Seminole,Advance in Person,477,Lieutenant Governor,465,12
Seminole,Election Day,1698,Lieutenant Governor,1654,44
Seminole,Provisional,5,Lieutenant Governor,5,0
Spalding,Absentee by Mail,528,Lieutenant Governor,518,10
Spalding,Advance in Person,6771,Lieutenant Governor,6689,82
Spalding,Election Day,9378,Lieutenant Governor,9298,80
Spalding,Provisional,14,Lieutenant Governor,14,0
Stephens,Absentee by Mail,337,Lieutenant Governor,331,6
Stephens,Advance in Person,2604,Lieutenant Governor,2586,18
Stephens,Election Day,2225,Lieutenant Governor,2217,8
Stephens,Provisional,2,Lieutenant Governor,2,0
Stewart,Absentee by Mail,75,Lieutenant Governor,74,1
Stewart,Advance in Person,311,Lieutenant Governor,285,26
Stewart,Election Day,808,Lieutenant Governor,773,35
Stewart,Provisional,18,Lieutenant Governor,18,0
Sumter,Absentee by Mail,522,Lieutenant Governor,518,4
Sumter,Advance in Person,3280,Lieutenant Governor,3235,45
Sumter,Election Day,4191,Lieutenant Governor,4154,37
Sumter,Provisional,5,Lieutenant Governor,5,0
Talbot,Absentee by Mail,215,Lieutenant Governor,205,10
Talbot,Advance in Person,342,Lieutenant Governor,336,6
Talbot,Election Day,1588,Lieutenant Governor,1544,44
Talbot,Provisional,2,Lieutenant Governor,1,1
Taliaferro,Absentee by Mail,50,Lieutenant Governor,50,0
Taliaferro,Advance in Person,197,Lieutenant Governor,191,6
Taliaferro,Election Day,311,Lieutenant Governor,311,0
Taliaferro,Provisional,0,Lieutenant Governor,0,0
Tattnall,Absentee by Mail,198,Lieutenant Governor,197,1
Tattnall,Advance in Person,1310,Lieutenant Governor,1289,21
Tattnall,Election Day,2706,Lieutenant Governor,2667,39
Tattnall,Provisional,6,Lieutenant Governor,6,0
Taylor,Absentee by Mail,127,Lieutenant Governor,125,2
Taylor,Advance in Person,620,Lieutenant Governor,609,11
Taylor,Election Day,1441,Lieutenant Governor,1427,14
Taylor,Provisional,0,Lieutenant Governor,0,0
Telfair,Absentee by Mail,227,Lieutenant Governor,225,2
Telfair,Advance in Person,751,Lieutenant Governor,736,15
Telfair,Election Day,1723,Lieutenant Governor,1680,43
Telfair,Provisional,0,Lieutenant Governor,0,0
Terrell,Absentee by Mail,258,Lieutenant Governor,243,15
Terrell,Advance in Person,1101,Lieutenant Governor,1067,34
Terrell,Election Day,1887,Lieutenant Governor,1856,31
Terrell,Provisional,2,Lieutenant Governor,2,0
Thomas,Absentee by Mail,293,Lieutenant Governor,290,3
Thomas,Advance in Person,3653,Lieutenant Governor,3625,28
Thomas,Election Day,7055,Lieutenant Governor,7012,43
Thomas,Provisional,2,Lieutenant Governor,2,0
Tift,Absentee by Mail,254,Lieutenant Governor,250,4
Tift,Advance in Person,3128,Lieutenant Governor,3119,9
Tift,Election Day,5030,Lieutenant Governor,4952,78
Tift,Provisional,92,Lieutenant Governor,87,5
Toombs,Absentee by Mail,381,Lieutenant Governor,378,3
Toombs,Advance in Person,1805,Lieutenant Governor,1789,16
Toombs,Election Day,3352,Lieutenant Governor,3339,13
Toombs,Provisional,6,Lieutenant Governor,6,0
Towns,Absentee by Mail,190,Lieutenant Governor,190,0
Towns,Advance in Person,2289,Lieutenant Governor,2256,33
Towns,Election Day,1717,Lieutenant Governor,1706,11
Towns,Provisional,68,Lieutenant Governor,66,2
Treutlen,Absentee by Mail,50,Lieutenant Governor,49,1
Treutlen,Advance in Person,426,Lieutenant Governor,419,7
Treutlen,Election Day,1041,Lieutenant Governor,1036,5
Treutlen,Provisional,3,Lieutenant Governor,3,0
Troup,Absentee by Mail,847,Lieutenant Governor,831,16
Troup,Advance in Person,4821,Lieutenant Governor,4766,55
Troup,Election Day,9963,Lieutenant Governor,9903,60
Troup,Provisional,41,Lieutenant Governor,40,1
Turner,Absentee by Mail,41,Lieutenant Governor,38,3
Turner,Advance in Person,1026,Lieutenant Governor,1004,22
Turner,Election Day,1188,Lieutenant Governor,1165,23
Turner,Provisional,11,Lieutenant Governor,11,0
Twiggs,Absentee by Mail,275,Lieutenant Governor,272,3
Twiggs,Advance in Person,841,Lieutenant Governor,825,16
Twiggs,Election Day,1776,Lieutenant Governor,1743,33
Twiggs,Provisional,1,Lieutenant Governor,1,0
Union,Absentee by Mail,288,Lieutenant Governor,285,3
Union,Advance in Person,3487,Lieutenant Governor,3468,19
Union,Election Day,3966,Lieutenant Governor,3900,66
Union,Provisional,2,Lieutenant Governor,2,0
Upson,Absentee by Mail,230,Lieutenant Governor,225,5
Upson,Advance in Person,2400,Lieutenant Governor,2359,41
Upson,Election Day,4440,Lieutenant Governor,4417,23
Upson,Provisional,1,Lieutenant Governor,1,0
Walker,Absentee by Mail,617,Lieutenant Governor,607,10
Walker,Advance in Person,3646,Lieutenant Governor,3612,34
Walker,Election Day,8076,Lieutenant Governor,8018,58
Walker,Provisional,0,Lieutenant Governor,0,0
Walton,Absentee by Mail,1068,Lieutenant Governor,1057,11
Walton,Advance in Person,6096,Lieutenant Governor,6061,35
Walton,Election Day,18659,Lieutenant Governor,18555,104
Walton,Provisional,16,Lieutenant Governor,16,0
Ware,Absentee by Mail,326,Lieutenant Governor,326,0
Ware,Advance in Person,2081,Lieutenant Governor,2046,35
Ware,Election Day,4306,Lieutenant Governor,4261,45
Ware,Provisional,1,Lieutenant Governor,1,0
Warren,Absentee by Mail,60,Lieutenant Governor,59,1
Warren,Advance in Person,543,Lieutenant Governor,532,11
Warren,Election Day,889,Lieutenant Governor,882,7
Warren,Provisional,1,Lieutenant Governor,1,0
Washington,Absentee by Mail,355,Lieutenant Governor,351,4
Washington,Advance in Person,2324,Lieutenant Governor,2272,52
Washington,Election Day,3362,Lieutenant Governor,3289,73
Washington,Provisional,8,Lieutenant Governor,8,0
Wayne,Absentee by Mail,258,Lieutenant Governor,256,2
Wayne,Advance in Person,2152,Lieutenant Governor,2133,19
Wayne,Election Day,3740,Lieutenant Governor,3735,5
Wayne,Provisional,0,Lieutenant Governor,0,0
Webster,Absentee by Mail,80,Lieutenant Governor,79,1
Webster,Advance in Person,271,Lieutenant Governor,262,9
Webster,Election Day,426,Lieutenant Governor,412,14
Webster,Provisional,0,Lieutenant Governor,0,0
Wheeler,Absentee by Mail,87,Lieutenant Governor,86,1
Wheeler,Advance in Person,447,Lieutenant Governor,431,16
Wheeler,Election Day,959,Lieutenant Governor,941,18
Wheeler,Provisional,9,Lieutenant Governor,8,1
White,Absentee by Mail,447,Lieutenant Governor,440,7
White,Advance in Person,2267,Lieutenant Governor,2249,18
White,Election Day,4948,Lieutenant Governor,4897,51
White,Provisional,3,Lieutenant Governor,3,0
Whitfield,Absentee by Mail,478,Lieutenant Governor,473,5
Whitfield,Advance in Person,3511,Lieutenant Governor,3455,56
Whitfield,Election Day,11767,Lieutenant Governor,11591,176
Whitfield,Provisional,38,Lieutenant Governor,38,0
Wilcox,Absentee by Mail,144,Lieutenant Governor,144,0
Wilcox,Advance in Person,455,Lieutenant Governor,449,6
Wilcox,Election Day,1280,Lieutenant Governor,1267,13
Wilcox,Provisional,3,Lieutenant Governor,3,0
Wilkes,Absentee by Mail,104,Lieutenant Governor,103,1
Wilkes,Advance in Person,939,Lieutenant Governor,928,11
Wilkes,Election Day,2044,Lieutenant Governor,2017,27
Wilkes,Provisional,3,Lieutenant Governor,3,0
Wilkinson,Absentee by Mail,150,Lieutenant Governor,148,2
Wilkinson,Advance in Person,763,Lieutenant Governor,750,13
Wilkinson,Election Day,2227,Lieutenant Governor,2199,28
Wilkinson,Provisional,1,Lieutenant Governor,1,0
Worth,Absentee by Mail,138,Lieutenant Governor,137,1
Worth,Advance in Person,1170,Lieutenant Governor,1157,13
Worth,Election Day,3871,Lieutenant Governor,3858,13
Worth,Provisional,10,Lieutenant Governor,10,0
Appling,Absentee by Mail,306,Secretary Of State,304,2
Appling,Advance in Person,976,Secretary Of State,962,14
Appling,Election Day,3122,Secretary Of State,3095,27
Appling,Provisional,4,Secretary Of State,4,0
Atkinson,Absentee by Mail,68,Secretary Of State,67,1
Atkinson,Advance in Person,495,Secretary Of State,480,15
Atkinson,Election Day,1058,Secretary Of State,1011,47
Atkinson,Provisional,7,Secretary Of State,7,0
Bacon,Absentee by Mail,73,Secretary Of State,71,2
Bacon,Advance in Person,887,Secretary Of State,882,5
Bacon,Election Day,1240,Secretary Of State,1239,1
Bacon,Provisional,3,Secretary Of State,3,0
Baker,Absentee by Mail,71,Secretary Of State,68,3
Baker,Advance in Person,298,Secretary Of State,293,5
Baker,Election Day,617,Secretary Of State,598,19
Baker,Provisional,3,Secretary Of State,3,0
Baldwin,Absentee by Mail,409,Secretary Of State,407,2
Baldwin,Advance in Person,3933,Secretary Of State,3883,50
Baldwin,Election Day,6152,Secretary Of State,6144,8
Baldwin,Provisional,9,Secretary Of State,9,0
Banks,Absentee by Mail,142,Secretary Of State,141,1
Banks,Advance in Person,852,Secretary Of State,839,13
Banks,Election Day,3339,Secretary Of State,3293,46
Banks,Provisional,1,Secretary Of State,1,0
Barrow,Absentee by Mail,701,Secretary Of State,690,11
Barrow,Advance in Person,4720,Secretary Of State,4720,0
Barrow,Election Day,10688,Secretary Of State,10627,61
Barrow,Provisional,8,Secretary Of State,8,0
Bartow,Absentee by Mail,772,Secretary Of State,760,12
Bartow,Advance in Person,5826,Secretary Of State,5804,22
Bartow,Election Day,16152,Secretary Of State,16023,129
Bartow,Provisional,20,Secretary Of State,20,0
Ben Hill,Absentee by Mail,136,Secretary Of State,133,3
Ben Hill,Advance in Person,1494,Secretary Of State,1470,24
Ben Hill,Election Day,1864,Secretary Of State,1857,7
Ben Hill,Provisional,3,Secretary Of State,3,0
Berrien,Absentee by Mail,212,Secretary Of State,211,1
Berrien,Advance in Person,1103,Secretary Of State,1102,1
Berrien,Election Day,2608,Secretary Of State,2598,10
Berrien,Provisional,8,Secretary Of State,8,0
Bibb,Absentee by Mail,2189,Secretary Of State,2160,29
Bibb,Advance in Person,10315,Secretary Of State,10212,103
Bibb,Election Day,29989,Secretary Of State,29753,236
Bibb,Provisional,78,Secretary Of State,78,0
Bleckley,Absentee by Mail,228,Secretary Of State,223,5
Bleckley,Advance in Person,1157,Secretary Of State,1140,17
Bleckley,Election Day,1855,Secretary Of State,1848,7
Bleckley,Provisional,5,Secretary Of State,4,1
Brantley,Absentee by Mail,143,Secretary Of State,143,0
Brantley,Advance in Person,747,Secretary Of State,747,0
Brantley,Election Day,2086,Secretary Of State,2084,2
Brantley,Provisional,4,Secretary Of State,4,0
Brooks,Absentee by Mail,1016,Secretary Of State,998,18
Brooks,Advance in Person,1259,Secretary Of State,1243,16
Brooks,Election Day,2355,Secretary Of State,2354,1
Brooks,Provisional,26,Secretary Of State,25,1
Bryan,Absentee by Mail,237,Secretary Of State,234,3
Bryan,Advance in Person,2852,Secretary Of State,2852,0
Bryan,Election Day,4863,Secretary Of State,4846,17
Bryan,Provisional,3,Secretary Of State,3,0
Bulloch,Absentee by Mail,541,Secretary Of State,536,5
Bulloch,Advance in Person,3846,Secretary Of State,3842,4
Bulloch,Election Day,9455,Secretary Of State,9355,100
Bulloch,Provisional,12,Secretary Of State,12,0
Burke,Absentee by Mail,594,Secretary Of State,590,4
Burke,Advance in Person,1260,Secretary Of State,1257,3
Burke,Election Day,4049,Secretary Of State,4013,36
Burke,Provisional,0,Secretary Of State,0,0
Butts,Absentee by Mail,183,Secretary Of State,180,3
Butts,Advance in Person,3252,Secretary Of State,3232,20
Butts,Election Day,2671,Secretary Of State,2659,12
Butts,Provisional,0,Secretary Of State,0,0
Calhoun,Absentee by Mail,91,Secretary Of State,90,1
Calhoun,Advance in Person,320,Secretary Of State,317,3
Calhoun,Election Day,1044,Secretary Of State,1043,1
Calhoun,Provisional,2,Secretary Of State,2,0
Camden,Absentee by Mail,586,Secretary Of State,582,4
Camden,Advance in Person,2509,Secretary Of State,2499,10
Camden,Election Day,6720,Secretary Of State,6720,0
Camden,Provisional,9,Secretary Of State,9,0
Candler,Absentee by Mail,108,Secretary Of State,108,0
Candler,Advance in Person,835,Secretary Of State,834,1
Candler,Election Day,1258,Secretary Of State,1251,7
Candler,Provisional,0,Secretary Of State,0,0
Carroll,Absentee by Mail,845,Secretary Of State,837,8
Carroll,Advance in Person,7673,Secretary Of State,7638,35
Carroll,Election Day,17495,Secretary Of State,17413,82
Carroll,Provisional,53,Secretary Of State,53,0
Catoosa,Absentee by Mail,456,Secretary Of State,449,7
Catoosa,Advance in Person,4909,Secretary Of State,4873,36
Catoosa,Election Day,8541,Secretary Of State,8447,94
Catoosa,Provisional,14,Secretary Of State,14,0
Charlton,Absentee by Mail,80,Secretary Of State,80,0
Charlton,Advance in Person,684,Secretary Of State,681,3
Charlton,Election Day,1247,Secretary Of State,1247,0
Charlton,Provisional,4,Secretary Of State,4,0
Chatham,Absentee by Mail,2948,Secretary Of State,2911,37
Chatham,Advance in Person,17241,Secretary Of State,17241,0
Chatham,Election Day,48480,Secretary Of State,48424,56
Chatham,Provisional,55,Secretary Of State,54,1
Chattahoochee,Absentee by Mail,22,Secretary Of State,22,0
Chattahoochee,Advance in Person,196,Secretary Of State,196,0
Chattahoochee,Election Day,481,Secretary Of State,476,5
Chattahoochee,Provisional,2,Secretary Of State,2,0
Chattooga,Absentee by Mail,107,Secretary Of State,104,3
Chattooga,Advance in Person,1625,Secretary Of State,1590,35
Chattooga,Election Day,3090,Secretary Of State,3041,49
Chattooga,Provisional,2,Secretary Of State,2,0
Cherokee,Absentee by Mail,2440,Secretary Of State,2386,54
Cherokee,Advance in Person,23437,Secretary Of State,23188,249
Cherokee,Election Day,40811,Secretary Of State,40205,606
Cherokee,Provisional,31,Secretary Of State,29,2
Clarke,Absentee by Mail,1152,Secretary Of State,1124,28
Clarke,Advance in Person,7332,Secretary Of State,7275,57
Clarke,Election Day,16976,Secretary Of State,16719,257
Clarke,Provisional,76,Secretary Of State,71,5
Clay,Absentee by Mail,90,Secretary Of State,89,1
Clay,Advance in Person,244,Secretary Of State,243,1
Clay,Election Day,602,Secretary Of State,599,3
Clay,Provisional,1,Secretary Of State,1,0
Clayton,Absentee by Mail,1772,Secretary Of State,1749,23
Clayton,Advance in Person,25878,Secretary Of State,25837,41
Clayton,Election Day,34794,Secretary Of State,34681,113
Clayton,Provisional,66,Secretary Of State,66,0
Clinch,Absentee by Mail,53,Secretary Of State,52,1
Clinch,Advance in Person,340,Secretary Of State,334,6
Clinch,Election Day,777,Secretary Of State,775,2
Clinch,Provisional,2,Secretary Of State,2,0
Cobb,Absentee by Mail,10616,Secretary Of State,10399,217
Cobb,Advance in Person,58755,Secretary Of State,58138,617
Cobb,Election Day,143123,Secretary Of State,140704,2419
Cobb,Provisional,581,Secretary Of State,563,18
Coffee,Absentee by Mail,328,Secretary Of State,328,0
Coffee,Advance in Person,3477,Secretary Of State,3470,7
Coffee,Election Day,4390,Secretary Of State,4340,50
Coffee,Provisional,7,Secretary Of State,7,0
Colquitt,Absentee by Mail,172,Secretary Of State,171,1
Colquitt,Advance in Person,2409,Secretary Of State,2395,14
Colquitt,Election Day,5359,Secretary Of State,5333,26
Colquitt,Provisional,4,Secretary Of State,4,0
Columbia,Absentee by Mail,1698,Secretary Of State,1682,16
Columbia,Advance in Person,11710,Secretary Of State,11703,7
Columbia,Election Day,26403,Secretary Of State,26378,25
Columbia,Provisional,10,Secretary Of State,10,0
Cook,Absentee by Mail,113,Secretary Of State,113,0
Cook,Advance in Person,1115,Secretary Of State,1112,3
Cook,Election Day,2316,Secretary Of State,2305,11
Cook,Provisional,0,Secretary Of State,0,0
Coweta,Absentee by Mail,1733,Secretary Of State,1704,29
Coweta,Advance in Person,9167,Secretary Of State,9135,32
Coweta,Election Day,26256,Secretary Of State,26093,163
Coweta,Provisional,15,Secretary Of State,15,0
Crawford,Absentee by Mail,146,Secretary Of State,146,0
Crawford,Advance in Person,1092,Secretary Of State,1078,14
Crawford,Election Day,2012,Secretary Of State,2012,0
Crawford,Provisional,4,Secretary Of State,4,0
Crisp,Absentee by Mail,169,Secretary Of State,166,3
Crisp,Advance in Person,2060,Secretary Of State,2045,15
Crisp,Election Day,2752,Secretary Of State,2732,20
Crisp,Provisional,2,Secretary Of State,2,0
Dade,Absentee by Mail,114,Secretary Of State,107,7
Dade,Advance in Person,1030,Secretary Of State,1005,25
Dade,Election Day,2283,Secretary Of State,2220,63
Dade,Provisional,9,Secretary Of State,9,0
Dawson,Absentee by Mail,311,Secretary Of State,308,3
Dawson,Advance in Person,3231,Secretary Of State,3194,37
Dawson,Election Day,3731,Secretary Of State,3677,54
Dawson,Provisional,11,Secretary Of State,11,0
DeKalb,Absentee by Mail,8280,Secretary Of State,8089,191
DeKalb,Advance in Person,72480,Secretary Of State,71823,657
DeKalb,Election Day,129376,Secretary Of State,126963,2413
DeKalb,Provisional,503,Secretary Of State,493,10
Decatur,Absentee by Mail,269,Secretary Of State,268,1
Decatur,Advance in Person,1985,Secretary Of State,1980,5
Decatur,Election Day,3820,Secretary Of State,3820,0
Decatur,Provisional,5,Secretary Of State,5,0
Dodge,Absentee by Mail,219,Secretary Of State,215,4
Dodge,Advance in Person,1690,Secretary Of State,1652,38
Dodge,Election Day,3173,Secretary Of State,3119,54
Dodge,Provisional,0,Secretary Of State,0,0
Dooly,Absentee by Mail,68,Secretary Of State,68,0
Dooly,Advance in Person,834,Secretary Of State,804,30
Dooly,Election Day,1783,Secretary Of State,1754,29
Dooly,Provisional,0,Secretary Of State,0,0
Dougherty,Absentee by Mail,1050,Secretary Of State,1034,16
Dougherty,Advance in Person,6272,Secretary Of State,6216,56
Dougherty,Election Day,16148,Secretary Of State,16120,28
Dougherty,Provisional,41,Secretary Of State,39,2
Douglas,Absentee by Mail,1308,Secretary Of State,1303,5
Douglas,Advance in Person,15797,Secretary Of State,15742,55
Douglas,Election Day,20398,Secretary Of State,20395,3
Douglas,Provisional,27,Secretary Of State,27,0
Early,Absentee by Mail,140,Secretary Of State,140,0
Early,Advance in Person,890,Secretary Of State,878,12
Early,Election Day,2163,Secretary Of State,2151,12
Early,Provisional,3,Secretary Of State,3,0
Echols,Absentee by Mail,19,Secretary Of State,19,0
Echols,Advance in Person,243,Secretary Of State,236,7
Echols,Election Day,361,Secretary Of State,357,4
Echols,Provisional,0,Secretary Of State,0,0
Effingham,Absentee by Mail,373,Secretary Of State,369,4
Effingham,Advance in Person,3036,Secretary Of State,3036,0
Effingham,Election Day,9204,Secretary Of State,9194,10
Effingham,Provisional,10,Secretary Of State,10,0
Elbert,Absentee by Mail,219,Secretary Of State,217,2
Elbert,Advance in Person,1841,Secretary Of State,1828,13
Elbert,Election Day,2632,Secretary Of State,2627,5
Elbert,Provisional,11,Secretary Of State,11,0
Emanuel,Absentee by Mail,213,Secretary Of State,207,6
Emanuel,Advance in Person,1187,Secretary Of State,1172,15
Emanuel,Election Day,3581,Secretary Of State,3530,51
Emanuel,Provisional,1,Secretary Of State,1,0
Evans,Absentee by Mail,122,Secretary Of State,122,0
Evans,Advance in Person,921,Secretary Of State,912,9
Evans,Election Day,1107,Secretary Of State,1098,9
Evans,Provisional,0,Secretary Of State,0,0
Fannin,Absentee by Mail,417,Secretary Of State,410,7
Fannin,Advance in Person,2268,Secretary Of State,2242,26
Fannin,Election Day,4216,Secretary Of State,4158,58
Fannin,Provisional,3,Secretary Of State,2,1
Fayette,Absentee by Mail,1272,Secretary Of State,1250,22
Fayette,Advance in Person,18189,Secretary Of State,18028,161
Fayette,Election Day,22606,Secretary Of State,22311,295
Fayette,Provisional,13,Secretary Of State,13,0
Floyd,Absentee by Mail,771,Secretary Of State,757,14
Floyd,Advance in Person,5763,Secretary Of State,5737,26
Floyd,Election Day,14210,Secretary Of State,14048,162
Floyd,Provisional,78,Secretary Of State,72,6
Forsyth,Absentee by Mail,1655,Secretary Of State,1625,30
Forsyth,Advance in Person,22647,Secretary Of State,22451,196
Forsyth,Election Day,32220,Secretary Of State,31880,340
Forsyth,Provisional,48,Secretary Of State,47,1
Franklin,Absentee by Mail,198,Secretary Of State,193,5
Franklin,Advance in Person,1077,Secretary Of State,1068,9
Franklin,Election Day,3454,Secretary Of State,3453,1
Franklin,Provisional,1,Secretary Of State,1,0
Fulton,Absentee by Mail,8864,Secretary Of State,8605,259
Fulton,Advance in Person,87201,Secretary Of State,86171,1030
Fulton,Election Day,167468,Secretary Of State,164453,3015
Fulton,Provisional,2135,Secretary Of State,2064,71
Gilmer,Absentee by Mail,378,Secretary Of State,371,7
Gilmer,Advance in Person,2578,Secretary Of State,2477,101
Gilmer,Election Day,4854,Secretary Of State,4584,270
Gilmer,Provisional,16,Secretary Of State,16,0
Glascock,Absentee by Mail,36,Secretary Of State,34,2
Glascock,Advance in Person,211,Secretary Of State,209,2
Glascock,Election Day,542,Secretary Of State,541,1
Glascock,Provisional,0,Secretary Of State,0,0
Glynn,Absentee by Mail,883,Secretary Of State,874,9
Glynn,Advance in Person,7098,Secretary Of State,7098,0
Glynn,Election Day,12102,Secretary Of State,12102,0
Glynn,Provisional,36,Secretary Of State,35,1
Gordon,Absentee by Mail,370,Secretary Of State,363,7
Gordon,Advance in Person,2666,Secretary Of State,2611,55
Gordon,Election Day,7273,Secretary Of State,7127,146
Gordon,Provisional,16,Secretary Of State,14,2
Grady,Absentee by Mail,157,Secretary Of State,156,1
Grady,Advance in Person,1854,Secretary Of State,1838,16
Grady,Election Day,3548,Secretary Of State,3544,4
Grady,Provisional,6,Secretary Of State,6,0
Greene,Absentee by Mail,538,Secretary Of State,538,0
Greene,Advance in Person,3068,Secretary Of State,3059,9
Greene,Election Day,2907,Secretary Of State,2865,42
Greene,Provisional,10,Secretary Of State,10,0
Gwinnett,Absentee by Mail,8170,Secretary Of State,8008,162
Gwinnett,Advance in Person,47244,Secretary Of State,47040,204
Gwinnett,Election Day,141636,Secretary Of State,140344,1292
Gwinnett,Provisional,1155,Secretary Of State,1139,16
Habersham,Absentee by Mail,704,Secretary Of State,691,13
Habersham,Advance in Person,5381,Secretary Of State,5289,92
Habersham,Election Day,3529,Secretary Of State,3482,47
Habersham,Provisional,34,Secretary Of State,30,4
Hall,Absentee by Mail,2074,Secretary Of State,2029,45
Hall,Advance in Person,12299,Secretary Of State,12145,154
Hall,Election Day,29428,Secretary Of State,29090,338
Hall,Provisional,42,Secretary Of State,42,0
Hancock,Absentee by Mail,283,Secretary Of State,282,1
Hancock,Advance in Person,839,Secretary Of State,821,18
Hancock,Election Day,1257,Secretary Of State,1241,16
Hancock,Provisional,19,Secretary Of State,18,1
Haralson,Absentee by Mail,262,Secretary Of State,260,2
Haralson,Advance in Person,1563,Secretary Of State,1546,17
Haralson,Election Day,4986,Secretary Of State,4925,61
Haralson,Provisional,2,Secretary Of State,2,0
Harris,Absentee by Mail,493,Secretary Of State,487,6
Harris,Advance in Person,2950,Secretary Of State,2949,1
Harris,Election Day,6803,Secretary Of State,6794,9
Harris,Provisional,2,Secretary Of State,2,0
Hart,Absentee by Mail,287,Secretary Of State,282,5
Hart,Advance in Person,2309,Secretary Of State,2274,35
Hart,Election Day,4185,Secretary Of State,4163,22
Hart,Provisional,1,Secretary Of State,1,0
Heard,Absentee by Mail,157,Secretary Of State,156,1
Heard,Advance in Person,552,Secretary Of State,545,7
Heard,Election Day,1772,Secretary Of State,1749,23
Heard,Provisional,0,Secretary Of State,0,0
Henry,Absentee by Mail,2016,Secretary Of State,1985,31
Henry,Advance in Person,29231,Secretary Of State,29184,47
Henry,Election Day,31732,Secretary Of State,31647,85
Henry,Provisional,102,Secretary Of State,100,2
Houston,Absentee by Mail,1431,Secretary Of State,1416,15
Houston,Advance in Person,16400,Secretary Of State,16349,51
Houston,Election Day,19454,Secretary Of State,19382,72
Houston,Provisional,62,Secretary Of State,58,4
Irwin,Absentee by Mail,61,Secretary Of State,60,1
Irwin,Advance in Person,719,Secretary Of State,691,28
Irwin,Election Day,1581,Secretary Of State,1559,22
Irwin,Provisional,3,Secretary Of State,2,1
Jackson,Absentee by Mail,495,Secretary Of State,489,6
Jackson,Advance in Person,5419,Secretary Of State,5395,24
Jackson,Election Day,10060,Secretary Of State,9996,64
Jackson,Provisional,16,Secretary Of State,15,1
Jasper,Absentee by Mail,255,Secretary Of State,251,4
Jasper,Advance in Person,1280,Secretary Of State,1275,5
Jasper,Election Day,2305,Secretary Of State,2295,10
Jasper,Provisional,2,Secretary Of State,2,0
Jeff Davis,Absentee by Mail,153,Secretary Of State,148,5
Jeff Davis,Advance in Person,861,Secretary Of State,846,15
Jeff Davis,Election Day,1973,Secretary Of State,1932,41
Jeff Davis,Provisional,1,Secretary Of State,1,0
Jefferson,Absentee by Mail,216,Secretary Of State,214,2
Jefferson,Advance in Person,1158,Secretary Of State,1149,9
Jefferson,Election Day,3144,Secretary Of State,3130,14
Jefferson,Provisional,20,Secretary Of State,20,0
Jenkins,Absentee by Mail,163,Secretary Of State,163,0
Jenkins,Advance in Person,671,Secretary Of State,664,7
Jenkins,Election Day,1088,Secretary Of State,1071,17
Jenkins,Provisional,0,Secretary Of State,0,0
Johnson,Absentee by Mail,92,Secretary Of State,91,1
Johnson,Advance in Person,789,Secretary Of State,783,6
Johnson,Election Day,1415,Secretary Of State,1408,7
Johnson,Provisional,0,Secretary Of State,0,0
Jones,Absentee by Mail,511,Secretary Of State,504,7
Jones,Advance in Person,2913,Secretary Of State,2903,10
Jones,Election Day,4638,Secretary Of State,4632,6
Jones,Provisional,7,Secretary Of State,7,0
Lamar,Absentee by Mail,215,Secretary Of State,210,5
Lamar,Advance in Person,1700,Secretary Of State,1685,15
Lamar,Election Day,3046,Secretary Of State,3037,9
Lamar,Provisional,5,Secretary Of State,5,0
Lanier,Absentee by Mail,40,Secretary Of State,40,0
Lanier,Advance in Person,521,Secretary Of State,521,0
Lanier,Election Day,878,Secretary Of State,878,0
Lanier,Provisional,4,Secretary Of State,4,0
Laurens,Absentee by Mail,763,Secretary Of State,756,7
Laurens,Advance in Person,3953,Secretary Of State,3937,16
Laurens,Election Day,8153,Secretary Of State,8056,97
Laurens,Provisional,14,Secretary Of State,14,0
Lee,Absentee by Mail,241,Secretary Of State,238,3
Lee,Advance in Person,2107,Secretary Of State,2097,10
Lee,Election Day,6514,Secretary Of State,6514,0
Lee,Provisional,5,Secretary Of State,5,0
Liberty,Absentee by Mail,209,Secretary Of State,206,3
Liberty,Advance in Person,3652,Secretary Of State,3637,15
Liberty,Election Day,5097,Secretary Of State,5090,7
Liberty,Provisional,4,Secretary Of State,4,0
Lincoln,Absentee by Mail,222,Secretary Of State,220,2
Lincoln,Advance in Person,899,Secretary Of State,895,4
Lincoln,Election Day,1554,Secretary Of State,1542,12
Lincoln,Provisional,13,Secretary Of State,13,0
Long,Absentee by Mail,40,Secretary Of State,40,0
Long,Advance in Person,691,Secretary Of State,691,0
Long,Election Day,1397,Secretary Of State,1387,10
Long,Provisional,6,Secretary Of State,6,0
Lowndes,Absentee by Mail,532,Secretary Of State,529,3
Lowndes,Advance in Person,8813,Secretary Of State,8813,0
Lowndes,Election Day,11478,Secretary Of State,11467,11
Lowndes,Provisional,560,Secretary Of State,555,5
Lumpkin,Absentee by Mail,305,Secretary Of State,300,5
Lumpkin,Advance in Person,2933,Secretary Of State,2897,36
Lumpkin,Election Day,4404,Secretary Of State,4339,65
Lumpkin,Provisional,15,Secretary Of State,15,0
Macon,Absentee by Mail,106,Secretary Of State,106,0
Macon,Advance in Person,1207,Secretary Of State,1164,43
Macon,Election Day,1695,Secretary Of State,1652,43
Macon,Provisional,0,Secretary Of State,0,0
Madison,Absentee by Mail,312,Secretary Of State,312,0
Madison,Advance in Person,2257,Secretary Of State,2254,3
Madison,Election Day,4970,Secretary Of State,4934,36
Madison,Provisional,6,Secretary Of State,6,0
Marion,Absentee by Mail,219,Secretary Of State,216,3
Marion,Advance in Person,612,Secretary Of State,603,9
Marion,Election Day,1314,Secretary Of State,1298,16
Marion,Provisional,0,Secretary Of State,0,0
McDuffie,Absentee by Mail,351,Secretary Of State,348,3
McDuffie,Advance in Person,2043,Secretary Of State,2030,13
McDuffie,Election Day,3653,Secretary Of State,3639,14
McDuffie,Provisional,3,Secretary Of State,3,0
McIntosh,Absentee by Mail,300,Secretary Of State,295,5
McIntosh,Advance in Person,1300,Secretary Of State,1300,0
McIntosh,Election Day,2233,Secretary Of State,2227,6
McIntosh,Provisional,7,Secretary Of State,6,1
Meriwether,Absentee by Mail,207,Secretary Of State,201,6
Meriwether,Advance in Person,1188,Secretary Of State,1180,8
Meriwether,Election Day,4671,Secretary Of State,4610,61
Meriwether,Provisional,1,Secretary Of State,1,0
Miller,Absentee by Mail,53,Secretary Of State,52,1
Miller,Advance in Person,436,Secretary Of State,429,7
Miller,Election Day,937,Secretary Of State,931,6
Miller,Provisional,1,Secretary Of State,1,0
Mitchell,Absentee by Mail,202,Secretary Of State,200,2
Mitchell,Advance in Person,1589,Secretary Of State,1581,8
Mitchell,Election Day,3215,Secretary Of State,3192,23
Mitchell,Provisional,3,Secretary Of State,3,0
Monroe,Absentee by Mail,358,Secretary Of State,353,5
Monroe,Advance in Person,2523,Secretary Of State,2489,34
Monroe,Election Day,5671,Secretary Of State,5625,46
Monroe,Provisional,23,Secretary Of State,22,1
Montgomery,Absentee by Mail,92,Secretary Of State,90,2
Montgomery,Advance in Person,463,Secretary Of State,455,8
Montgomery,Election Day,1730,Secretary Of State,1710,20
Montgomery,Provisional,0,Secretary Of State,0,0
Morgan,Absentee by Mail,193,Secretary Of State,190,3
Morgan,Advance in Person,2475,Secretary Of State,2466,9
Morgan,Election Day,3635,Secretary Of State,3607,28
Morgan,Provisional,7,Secretary Of State,6,1
Murray,Absentee by Mail,207,Secretary Of State,196,11
Murray,Advance in Person,1347,Secretary Of State,1316,31
Murray,Election Day,4497,Secretary Of State,4410,87
Murray,Provisional,0,Secretary Of State,0,0
Muscogee,Absentee by Mail,2150,Secretary Of State,2130,20
Muscogee,Advance in Person,13494,Secretary Of State,13426,68
Muscogee,Election Day,25301,Secretary Of State,25259,42
Muscogee,Provisional,63,Secretary Of State,63,0
Newton,Absentee by Mail,1136,Secretary Of State,1126,10
Newton,Advance in Person,10430,Secretary Of State,10410,20
Newton,Election Day,16634,Secretary Of State,16602,32
Newton,Provisional,2,Secretary Of State,2,0
Oconee,Absentee by Mail,368,Secretary Of State,359,9
Oconee,Advance in Person,5438,Secretary Of State,5395,43
Oconee,Election Day,7726,Secretary Of State,7601,125
Oconee,Provisional,7,Secretary Of State,7,0
Oglethorpe,Absentee by Mail,217,Secretary Of State,217,0
Oglethorpe,Advance in Person,1609,Secretary Of State,1602,7
Oglethorpe,Election Day,2262,Secretary Of State,2262,0
Oglethorpe,Provisional,4,Secretary Of State,4,0
Paulding,Absentee by Mail,1789,Secretary Of State,1766,23
Paulding,Advance in Person,14824,Secretary Of State,14792,32
Paulding,Election Day,19620,Secretary Of State,19576,44
Paulding,Provisional,29,Secretary Of State,28,1
Peach,Absentee by Mail,215,Secretary Of State,212,3
Peach,Advance in Person,3402,Secretary Of State,3376,26
Peach,Election Day,3620,Secretary Of State,3616,4
Peach,Provisional,8,Secretary Of State,8,0
Pickens,Absentee by Mail,138,Secretary Of State,135,3
Pickens,Advance in Person,3653,Secretary Of State,3595,58
Pickens,Election Day,5031,Secretary Of State,4982,49
Pickens,Provisional,1,Secretary Of State,1,0
Pierce,Absentee by Mail,228,Secretary Of State,225,3
Pierce,Advance in Person,1629,Secretary Of State,1610,19
Pierce,Election Day,2106,Secretary Of State,2102,4
Pierce,Provisional,0,Secretary Of State,0,0
Pike,Absentee by Mail,246,Secretary Of State,242,4
Pike,Advance in Person,1650,Secretary Of State,1645,5
Pike,Election Day,3700,Secretary Of State,3678,22
Pike,Provisional,8,Secretary Of State,8,0
Polk,Absentee by Mail,235,Secretary Of State,231,4
Polk,Advance in Person,3214,Secretary Of State,3199,15
Polk,Election Day,4537,Secretary Of State,4484,53
Polk,Provisional,4,Secretary Of State,4,0
Pulaski,Absentee by Mail,86,Secretary Of State,85,1
Pulaski,Advance in Person,1249,Secretary Of State,1230,19
Pulaski,Election Day,1013,Secretary Of State,995,18
Pulaski,Provisional,2,Secretary Of State,2,0
Putnam,Absentee by Mail,387,Secretary Of State,385,2
Putnam,Advance in Person,2434,Secretary Of State,2417,17
Putnam,Election Day,3451,Secretary Of State,3428,23
Putnam,Provisional,2,Secretary Of State,2,0
Quitman,Absentee by Mail,41,Secretary Of State,41,0
Quitman,Advance in Person,209,Secretary Of State,208,1
Quitman,Election Day,347,Secretary Of State,347,0
Quitman,Provisional,1,Secretary Of State,1,0
Rabun,Absentee by Mail,427,Secretary Of State,417,10
Rabun,Advance in Person,3295,Secretary Of State,3203,92
Rabun,Election Day,1731,Secretary Of State,1670,61
Rabun,Provisional,0,Secretary Of State,0,0
Randolph,Absentee by Mail,149,Secretary Of State,145,4
Randolph,Advance in Person,789,Secretary Of State,774,15
Randolph,Election Day,1173,Secretary Of State,1155,18
Randolph,Provisional,7,Secretary Of State,6,1
Richmond,Absentee by Mail,3207,Secretary Of State,3157,50
Richmond,Advance in Person,13314,Secretary Of State,13253,61
Richmond,Election Day,31248,Secretary Of State,31126,122
Richmond,Provisional,71,Secretary Of State,69,2
Rockdale,Absentee by Mail,825,Secretary Of State,814,11
Rockdale,Advance in Person,13442,Secretary Of State,13417,25
Rockdale,Election Day,12256,Secretary Of State,12222,34
Rockdale,Provisional,48,Secretary Of State,48,0
Schley,Absentee by Mail,66,Secretary Of State,65,1
Schley,Advance in Person,602,Secretary Of State,602,0
Schley,Election Day,595,Secretary Of State,594,1
Schley,Provisional,3,Secretary Of State,3,0
Screven,Absentee by Mail,158,Secretary Of State,155,3
Screven,Advance in Person,1201,Secretary Of State,1187,14
Screven,Election Day,2412,Secretary Of State,2399,13
Screven,Provisional,4,Secretary Of State,4,0
Seminole,Absentee by Mail,76,Secretary Of State,76,0
Seminole,Advance in Person,477,Secretary Of State,470,7
Seminole,Election Day,1698,Secretary Of State,1684,14
Seminole,Provisional,5,Secretary Of State,5,0
Spalding,Absentee by Mail,528,Secretary Of State,514,14
Spalding,Advance in Person,6771,Secretary Of State,6697,74
Spalding,Election Day,9378,Secretary Of State,9297,81
Spalding,Provisional,14,Secretary Of State,14,0
Stephens,Absentee by Mail,337,Secretary Of State,328,9
Stephens,Advance in Person,2604,Secretary Of State,2592,12
Stephens,Election Day,2225,Secretary Of State,2221,4
Stephens,Provisional,2,Secretary Of State,2,0
Stewart,Absentee by Mail,75,Secretary Of State,74,1
Stewart,Advance in Person,311,Secretary Of State,288,23
Stewart,Election Day,808,Secretary Of State,783,25
Stewart,Provisional,18,Secretary Of State,18,0
Sumter,Absentee by Mail,522,Secretary Of State,520,2
Sumter,Advance in Person,3280,Secretary Of State,3256,24
Sumter,Election Day,4191,Secretary Of State,4141,50
Sumter,Provisional,5,Secretary Of State,5,0
Talbot,Absentee by Mail,215,Secretary Of State,206,9
Talbot,Advance in Person,342,Secretary Of State,336,6
Talbot,Election Day,1588,Secretary Of State,1558,30
Talbot,Provisional,2,Secretary Of State,1,1
Taliaferro,Absentee by Mail,50,Secretary Of State,48,2
Taliaferro,Advance in Person,197,Secretary Of State,195,2
Taliaferro,Election Day,311,Secretary Of State,306,5
Taliaferro,Provisional,0,Secretary Of State,0,0
Tattnall,Absentee by Mail,198,Secretary Of State,195,3
Tattnall,Advance in Person,1310,Secretary Of State,1296,14
Tattnall,Election Day,2706,Secretary Of State,2675,31
Tattnall,Provisional,6,Secretary Of State,6,0
Taylor,Absentee by Mail,127,Secretary Of State,127,0
Taylor,Advance in Person,620,Secretary Of State,612,8
Taylor,Election Day,1441,Secretary Of State,1433,8
Taylor,Provisional,0,Secretary Of State,0,0
Telfair,Absentee by Mail,227,Secretary Of State,225,2
Telfair,Advance in Person,751,Secretary Of State,728,23
Telfair,Election Day,1723,Secretary Of State,1701,22
Telfair,Provisional,0,Secretary Of State,0,0
Terrell,Absentee by Mail,258,Secretary Of State,241,17
Terrell,Advance in Person,1101,Secretary Of State,1082,19
Terrell,Election Day,1887,Secretary Of State,1868,19
Terrell,Provisional,2,Secretary Of State,2,0
Thomas,Absentee by Mail,293,Secretary Of State,289,4
Thomas,Advance in Person,3653,Secretary Of State,3633,20
Thomas,Election Day,7055,Secretary Of State,7044,11
Thomas,Provisional,2,Secretary Of State,2,0
Tift,Absentee by Mail,254,Secretary Of State,253,1
Tift,Advance in Person,3128,Secretary Of State,3111,17
Tift,Election Day,5030,Secretary Of State,4981,49
Tift,Provisional,92,Secretary Of State,89,3
Toombs,Absentee by Mail,381,Secretary Of State,378,3
Toombs,Advance in Person,1805,Secretary Of State,1791,14
Toombs,Election Day,3352,Secretary Of State,3341,11
Toombs,Provisional,6,Secretary Of State,6,0
Towns,Absentee by Mail,190,Secretary Of State,187,3
Towns,Advance in Person,2289,Secretary Of State,2247,42
Towns,Election Day,1717,Secretary Of State,1685,32
Towns,Provisional,68,Secretary Of State,65,3
Treutlen,Absentee by Mail,50,Secretary Of State,48,2
Treutlen,Advance in Person,426,Secretary Of State,424,2
Treutlen,Election Day,1041,Secretary Of State,1041,0
Treutlen,Provisional,3,Secretary Of State,3,0
Troup,Absentee by Mail,847,Secretary Of State,837,10
Troup,Advance in Person,4821,Secretary Of State,4805,16
Troup,Election Day,9963,Secretary Of State,9943,20
Troup,Provisional,41,Secretary Of State,38,3
Turner,Absentee by Mail,41,Secretary Of State,39,2
Turner,Advance in Person,1026,Secretary Of State,1019,7
Turner,Election Day,1188,Secretary Of State,1166,22
Turner,Provisional,11,Secretary Of State,11,0
Twiggs,Absentee by Mail,275,Secretary Of State,272,3
Twiggs,Advance in Person,841,Secretary Of State,826,15
Twiggs,Election Day,1776,Secretary Of State,1756,20
Twiggs,Provisional,1,Secretary Of State,1,0
Union,Absentee by Mail,288,Secretary Of State,283,5
Union,Advance in Person,3487,Secretary Of State,3457,30
Union,Election Day,3966,Secretary Of State,3885,81
Union,Provisional,2,Secretary Of State,2,0
Upson,Absentee by Mail,230,Secretary Of State,227,3
Upson,Advance in Person,2400,Secretary Of State,2371,29
Upson,Election Day,4440,Secretary Of State,4424,16
Upson,Provisional,1,Secretary Of State,1,0
Walker,Absentee by Mail,617,Secretary Of State,601,16
Walker,Advance in Person,3646,Secretary Of State,3633,13
Walker,Election Day,8076,Secretary Of State,8040,36
Walker,Provisional,0,Secretary Of State,0,0
Walton,Absentee by Mail,1068,Secretary Of State,1049,19
Walton,Advance in Person,6096,Secretary Of State,6070,26
Walton,Election Day,18659,Secretary Of State,18506,153
Walton,Provisional,16,Secretary Of State,16,0
Ware,Absentee by Mail,326,Secretary Of State,319,7
Ware,Advance in Person,2081,Secretary Of State,2071,10
Ware,Election Day,4306,Secretary Of State,4281,25
Ware,Provisional,1,Secretary Of State,1,0
Warren,Absentee by Mail,60,Secretary Of State,58,2
Warren,Advance in Person,543,Secretary Of State,537,6
Warren,Election Day,889,Secretary Of State,884,5
Warren,Provisional,1,Secretary Of State,1,0
Washington,Absentee by Mail,355,Secretary Of State,349,6
Washington,Advance in Person,2324,Secretary Of State,2284,40
Washington,Election Day,3362,Secretary Of State,3286,76
Washington,Provisional,8,Secretary Of State,8,0
Wayne,Absentee by Mail,258,Secretary Of State,254,4
Wayne,Advance in Person,2152,Secretary Of State,2152,0
Wayne,Election Day,3740,Secretary Of State,3732,8
Wayne,Provisional,0,Secretary Of State,0,0
Webster,Absentee by Mail,80,Secretary Of State,76,4
Webster,Advance in Person,271,Secretary Of State,262,9
Webster,Election Day,426,Secretary Of State,413,13
Webster,Provisional,0,Secretary Of State,0,0
Wheeler,Absentee by Mail,87,Secretary Of State,86,1
Wheeler,Advance in Person,447,Secretary Of State,436,11
Wheeler,Election Day,959,Secretary Of State,954,5
Wheeler,Provisional,9,Secretary Of State,9,0
White,Absentee by Mail,447,Secretary Of State,436,11
White,Advance in Person,2267,Secretary Of State,2248,19
White,Election Day,4948,Secretary Of State,4884,64
White,Provisional,3,Secretary Of State,3,0
Whitfield,Absentee by Mail,478,Secretary Of State,471,7
Whitfield,Advance in Person,3511,Secretary Of State,3469,42
Whitfield,Election Day,11767,Secretary Of State,11634,133
Whitfield,Provisional,38,Secretary Of State,38,0
Wilcox,Absentee by Mail,144,Secretary Of State,142,2
Wilcox,Advance in Person,455,Secretary Of State,445,10
Wilcox,Election Day,1280,Secretary Of State,1269,11
Wilcox,Provisional,3,Secretary Of State,3,0
Wilkes,Absentee by Mail,104,Secretary Of State,103,1
Wilkes,Advance in Person,939,Secretary Of State,927,12
Wilkes,Election Day,2044,Secretary Of State,2026,18
Wilkes,Provisional,3,Secretary Of State,3,0
Wilkinson,Absentee by Mail,150,Secretary Of State,148,2
Wilkinson,Advance in Person,763,Secretary Of State,756,7
Wilkinson,Election Day,2227,Secretary Of State,2193,34
Wilkinson,Provisional,1,Secretary Of State,1,0
Worth,Absentee by Mail,138,Secretary Of State,137,1
Worth,Advance in Person,1170,Secretary Of State,1168,2
Worth,Election Day,3871,Secretary Of State,3845,26
Worth,Provisional,10,Secretary Of State,10,0
Appling,Absentee by Mail,306,Attorney General,303,3
Appling,Advance in Person,976,Attorney General,970,6
Appling,Election Day,3122,Attorney General,3085,37
Appling,Provisional,4,Attorney General,4,0
Atkinson,Absentee by Mail,68,Attorney General,67,1
Atkinson,Advance in Person,495,Attorney General,475,20
Atkinson,Election Day,1058,Attorney General,1003,55
Atkinson,Provisional,7,Attorney General,6,1
Bacon,Absentee by Mail,73,Attorney General,73,0
Bacon,Advance in Person,887,Attorney General,875,12
Bacon,Election Day,1240,Attorney General,1223,17
Bacon,Provisional,3,Attorney General,3,0
Baker,Absentee by Mail,71,Attorney General,67,4
Baker,Advance in Person,298,Attorney General,290,8
Baker,Election Day,617,Attorney General,592,25
Baker,Provisional,3,Attorney General,3,0
Baldwin,Absentee by Mail,409,Attorney General,404,5
Baldwin,Advance in Person,3933,Attorney General,3881,52
Baldwin,Election Day,6152,Attorney General,6134,18
Baldwin,Provisional,9,Attorney General,9,0
Banks,Absentee by Mail,142,Attorney General,138,4
Banks,Advance in Person,852,Attorney General,834,18
Banks,Election Day,3339,Attorney General,3294,45
Banks,Provisional,1,Attorney General,1,0
Barrow,Absentee by Mail,701,Attorney General,692,9
Barrow,Advance in Person,4720,Attorney General,4710,10
Barrow,Election Day,10688,Attorney General,10613,75
Barrow,Provisional,8,Attorney General,8,0
Bartow,Absentee by Mail,772,Attorney General,759,13
Bartow,Advance in Person,5826,Attorney General,5814,12
Bartow,Election Day,16152,Attorney General,16034,118
Bartow,Provisional,20,Attorney General,20,0
Ben Hill,Absentee by Mail,136,Attorney General,132,4
Ben Hill,Advance in Person,1494,Attorney General,1468,26
Ben Hill,Election Day,1864,Attorney General,1856,8
Ben Hill,Provisional,3,Attorney General,3,0
Berrien,Absentee by Mail,212,Attorney General,211,1
Berrien,Advance in Person,1103,Attorney General,1091,12
Berrien,Election Day,2608,Attorney General,2595,13
Berrien,Provisional,8,Attorney General,8,0
Bibb,Absentee by Mail,2189,Attorney General,2151,38
Bibb,Advance in Person,10315,Attorney General,10200,115
Bibb,Election Day,29989,Attorney General,29695,294
Bibb,Provisional,78,Attorney General,78,0
Bleckley,Absentee by Mail,228,Attorney General,219,9
Bleckley,Advance in Person,1157,Attorney General,1134,23
Bleckley,Election Day,1855,Attorney General,1835,20
Bleckley,Provisional,5,Attorney General,4,1
Brantley,Absentee by Mail,143,Attorney General,140,3
Brantley,Advance in Person,747,Attorney General,733,14
Brantley,Election Day,2086,Attorney General,2062,24
Brantley,Provisional,4,Attorney General,4,0
Brooks,Absentee by Mail,1016,Attorney General,989,27
Brooks,Advance in Person,1259,Attorney General,1238,21
Brooks,Election Day,2355,Attorney General,2342,13
Brooks,Provisional,26,Attorney General,25,1
Bryan,Absentee by Mail,237,Attorney General,230,7
Bryan,Advance in Person,2852,Attorney General,2839,13
Bryan,Election Day,4863,Attorney General,4841,22
Bryan,Provisional,3,Attorney General,3,0
Bulloch,Absentee by Mail,541,Attorney General,536,5
Bulloch,Advance in Person,3846,Attorney General,3818,28
Bulloch,Election Day,9455,Attorney General,9358,97
Bulloch,Provisional,12,Attorney General,12,0
Burke,Absentee by Mail,594,Attorney General,588,6
Burke,Advance in Person,1260,Attorney General,1251,9
Burke,Election Day,4049,Attorney General,4000,49
Burke,Provisional,0,Attorney General,0,0
Butts,Absentee by Mail,183,Attorney General,182,1
Butts,Advance in Person,3252,Attorney General,3232,20
Butts,Election Day,2671,Attorney General,2646,25
Butts,Provisional,0,Attorney General,0,0
Calhoun,Absentee by Mail,91,Attorney General,90,1
Calhoun,Advance in Person,320,Attorney General,317,3
Calhoun,Election Day,1044,Attorney General,1030,14
Calhoun,Provisional,2,Attorney General,2,0
Camden,Absentee by Mail,586,Attorney General,580,6
Camden,Advance in Person,2509,Attorney General,2489,20
Camden,Election Day,6720,Attorney General,6689,31
Camden,Provisional,9,Attorney General,9,0
Candler,Absentee by Mail,108,Attorney General,107,1
Candler,Advance in Person,835,Attorney General,829,6
Candler,Election Day,1258,Attorney General,1249,9
Candler,Provisional,0,Attorney General,0,0
Carroll,Absentee by Mail,845,Attorney General,832,13
Carroll,Advance in Person,7673,Attorney General,7616,57
Carroll,Election Day,17495,Attorney General,17414,81
Carroll,Provisional,53,Attorney General,52,1
Catoosa,Absentee by Mail,456,Attorney General,447,9
Catoosa,Advance in Person,4909,Attorney General,4856,53
Catoosa,Election Day,8541,Attorney General,8401,140
Catoosa,Provisional,14,Attorney General,14,0
Charlton,Absentee by Mail,80,Attorney General,80,0
Charlton,Advance in Person,684,Attorney General,678,6
Charlton,Election Day,1247,Attorney General,1226,21
Charlton,Provisional,4,Attorney General,4,0
Chatham,Absentee by Mail,2948,Attorney General,2890,58
Chatham,Advance in Person,17241,Attorney General,17232,9
Chatham,Election Day,48480,Attorney General,48300,180
Chatham,Provisional,55,Attorney General,52,3
Chattahoochee,Absentee by Mail,22,Attorney General,22,0
Chattahoochee,Advance in Person,196,Attorney General,196,0
Chattahoochee,Election Day,481,Attorney General,473,8
Chattahoochee,Provisional,2,Attorney General,2,0
Chattooga,Absentee by Mail,107,Attorney General,105,2
Chattooga,Advance in Person,1625,Attorney General,1578,47
Chattooga,Election Day,3090,Attorney General,3036,54
Chattooga,Provisional,2,Attorney General,2,0
Cherokee,Absentee by Mail,2440,Attorney General,2383,57
Cherokee,Advance in Person,23437,Attorney General,23189,248
Cherokee,Election Day,40811,Attorney General,40237,574
Cherokee,Provisional,31,Attorney General,28,3
Clarke,Absentee by Mail,1152,Attorney General,1112,40
Clarke,Advance in Person,7332,Attorney General,7203,129
Clarke,Election Day,16976,Attorney General,16573,403
Clarke,Provisional,76,Attorney General,71,5
Clay,Absentee by Mail,90,Attorney General,87,3
Clay,Advance in Person,244,Attorney General,237,7
Clay,Election Day,602,Attorney General,596,6
Clay,Provisional,1,Attorney General,1,0
Clayton,Absentee by Mail,1772,Attorney General,1759,13
Clayton,Advance in Person,25878,Attorney General,25819,59
Clayton,Election Day,34794,Attorney General,34690,104
Clayton,Provisional,66,Attorney General,65,1
Clinch,Absentee by Mail,53,Attorney General,52,1
Clinch,Advance in Person,340,Attorney General,337,3
Clinch,Election Day,777,Attorney General,765,12
Clinch,Provisional,2,Attorney General,2,0
Cobb,Absentee by Mail,10616,Attorney General,10423,193
Cobb,Advance in Person,58755,Attorney General,58231,524
Cobb,Election Day,143123,Attorney General,140908,2215
Cobb,Provisional,581,Attorney General,565,16
Coffee,Absentee by Mail,328,Attorney General,324,4
Coffee,Advance in Person,3477,Attorney General,3438,39
Coffee,Election Day,4390,Attorney General,4310,80
Coffee,Provisional,7,Attorney General,7,0
Colquitt,Absentee by Mail,172,Attorney General,169,3
Colquitt,Advance in Person,2409,Attorney General,2384,25
Colquitt,Election Day,5359,Attorney General,5322,37
Colquitt,Provisional,4,Attorney General,4,0
Columbia,Absentee by Mail,1698,Attorney General,1655,43
Columbia,Advance in Person,11710,Attorney General,11690,20
Columbia,Election Day,26403,Attorney General,26345,58
Columbia,Provisional,10,Attorney General,9,1
Cook,Absentee by Mail,113,Attorney General,113,0
Cook,Advance in Person,1115,Attorney General,1107,8
Cook,Election Day,2316,Attorney General,2295,21
Cook,Provisional,0,Attorney General,0,0
Coweta,Absentee by Mail,1733,Attorney General,1706,27
Coweta,Advance in Person,9167,Attorney General,9137,30
Coweta,Election Day,26256,Attorney General,26103,153
Coweta,Provisional,15,Attorney General,15,0
Crawford,Absentee by Mail,146,Attorney General,145,1
Crawford,Advance in Person,1092,Attorney General,1071,21
Crawford,Election Day,2012,Attorney General,1995,17
Crawford,Provisional,4,Attorney General,4,0
Crisp,Absentee by Mail,169,Attorney General,166,3
Crisp,Advance in Person,2060,Attorney General,2017,43
Crisp,Election Day,2752,Attorney General,2713,39
Crisp,Provisional,2,Attorney General,2,0
Dade,Absentee by Mail,114,Attorney General,107,7
Dade,Advance in Person,1030,Attorney General,985,45
Dade,Election Day,2283,Attorney General,2199,84
Dade,Provisional,9,Attorney General,9,0
Dawson,Absentee by Mail,311,Attorney General,306,5
Dawson,Advance in Person,3231,Attorney General,3189,42
Dawson,Election Day,3731,Attorney General,3648,83
Dawson,Provisional,11,Attorney General,10,1
DeKalb,Absentee by Mail,8280,Attorney General,7965,315
DeKalb,Advance in Person,72480,Attorney General,71766,714
DeKalb,Election Day,129376,Attorney General,126924,2452
DeKalb,Provisional,503,Attorney General,485,18
Decatur,Absentee by Mail,269,Attorney General,265,4
Decatur,Advance in Person,1985,Attorney General,1970,15
Decatur,Election Day,3820,Attorney General,3786,34
Decatur,Provisional,5,Attorney General,5,0
Dodge,Absentee by Mail,219,Attorney General,216,3
Dodge,Advance in Person,1690,Attorney General,1633,57
Dodge,Election Day,3173,Attorney General,3093,80
Dodge,Provisional,0,Attorney General,0,0
Dooly,Absentee by Mail,68,Attorney General,68,0
Dooly,Advance in Person,834,Attorney General,801,33
Dooly,Election Day,1783,Attorney General,1746,37
Dooly,Provisional,0,Attorney General,0,0
Dougherty,Absentee by Mail,1050,Attorney General,1032,18
Dougherty,Advance in Person,6272,Attorney General,6205,67
Dougherty,Election Day,16148,Attorney General,16095,53
Dougherty,Provisional,41,Attorney General,39,2
Douglas,Absentee by Mail,1308,Attorney General,1291,17
Douglas,Advance in Person,15797,Attorney General,15769,28
Douglas,Election Day,20398,Attorney General,20383,15
Douglas,Provisional,27,Attorney General,27,0
Early,Absentee by Mail,140,Attorney General,140,0
Early,Advance in Person,890,Attorney General,880,10
Early,Election Day,2163,Attorney General,2141,22
Early,Provisional,3,Attorney General,3,0
Echols,Absentee by Mail,19,Attorney General,19,0
Echols,Advance in Person,243,Attorney General,232,11
Echols,Election Day,361,Attorney General,355,6
Echols,Provisional,0,Attorney General,0,0
Effingham,Absentee by Mail,373,Attorney General,365,8
Effingham,Advance in Person,3036,Attorney General,3022,14
Effingham,Election Day,9204,Attorney General,9184,20
Effingham,Provisional,10,Attorney General,10,0
Elbert,Absentee by Mail,219,Attorney General,215,4
Elbert,Advance in Person,1841,Attorney General,1824,17
Elbert,Election Day,2632,Attorney General,2615,17
Elbert,Provisional,11,Attorney General,11,0
Emanuel,Absentee by Mail,213,Attorney General,205,8
Emanuel,Advance in Person,1187,Attorney General,1162,25
Emanuel,Election Day,3581,Attorney General,3527,54
Emanuel,Provisional,1,Attorney General,1,0
Evans,Absentee by Mail,122,Attorney General,120,2
Evans,Advance in Person,921,Attorney General,906,15
Evans,Election Day,1107,Attorney General,1090,17
Evans,Provisional,0,Attorney General,0,0
Fannin,Absentee by Mail,417,Attorney General,406,11
Fannin,Advance in Person,2268,Attorney General,2240,28
Fannin,Election Day,4216,Attorney General,4143,73
Fannin,Provisional,3,Attorney General,2,1
Fayette,Absentee by Mail,1272,Attorney General,1252,20
Fayette,Advance in Person,18189,Attorney General,18025,164
Fayette,Election Day,22606,Attorney General,22351,255
Fayette,Provisional,13,Attorney General,12,1
Floyd,Absentee by Mail,771,Attorney General,763,8
Floyd,Advance in Person,5763,Attorney General,5741,22
Floyd,Election Day,14210,Attorney General,14040,170
Floyd,Provisional,78,Attorney General,75,3
Forsyth,Absentee by Mail,1655,Attorney General,1611,44
Forsyth,Advance in Person,22647,Attorney General,22437,210
Forsyth,Election Day,32220,Attorney General,31830,390
Forsyth,Provisional,48,Attorney General,45,3
Franklin,Absentee by Mail,198,Attorney General,192,6
Franklin,Advance in Person,1077,Attorney General,1069,8
Franklin,Election Day,3454,Attorney General,3432,22
Franklin,Provisional,1,Attorney General,1,0
Fulton,Absentee by Mail,8864,Attorney General,8662,202
Fulton,Advance in Person,87201,Attorney General,86256,945
Fulton,Election Day,167468,Attorney General,164473,2995
Fulton,Provisional,2135,Attorney General,2066,69
Gilmer,Absentee by Mail,378,Attorney General,373,5
Gilmer,Advance in Person,2578,Attorney General,2530,48
Gilmer,Election Day,4854,Attorney General,4725,129
Gilmer,Provisional,16,Attorney General,16,0
Glascock,Absentee by Mail,36,Attorney General,33,3
Glascock,Advance in Person,211,Attorney General,209,2
Glascock,Election Day,542,Attorney General,540,2
Glascock,Provisional,0,Attorney General,0,0
Glynn,Absentee by Mail,883,Attorney General,871,12
Glynn,Advance in Person,7098,Attorney General,7081,17
Glynn,Election Day,12102,Attorney General,12068,34
Glynn,Provisional,36,Attorney General,34,2
Gordon,Absentee by Mail,370,Attorney General,357,13
Gordon,Advance in Person,2666,Attorney General,2608,58
Gordon,Election Day,7273,Attorney General,7126,147
Gordon,Provisional,16,Attorney General,14,2
Grady,Absentee by Mail,157,Attorney General,156,1
Grady,Advance in Person,1854,Attorney General,1831,23
Grady,Election Day,3548,Attorney General,3522,26
Grady,Provisional,6,Attorney General,6,0
Greene,Absentee by Mail,538,Attorney General,528,10
Greene,Advance in Person,3068,Attorney General,3044,24
Greene,Election Day,2907,Attorney General,2861,46
Greene,Provisional,10,Attorney General,10,0
Gwinnett,Absentee by Mail,8170,Attorney General,8007,163
Gwinnett,Advance in Person,47244,Attorney General,47002,242
Gwinnett,Election Day,141636,Attorney General,140090,1546
Gwinnett,Provisional,1155,Attorney General,1135,20
Habersham,Absentee by Mail,704,Attorney General,692,12
Habersham,Advance in Person,5381,Attorney General,5264,117
Habersham,Election Day,3529,Attorney General,3479,50
Habersham,Provisional,34,Attorney General,31,3
Hall,Absentee by Mail,2074,Attorney General,2041,33
Hall,Advance in Person,12299,Attorney General,12132,167
Hall,Election Day,29428,Attorney General,29000,428
Hall,Provisional,42,Attorney General,42,0
Hancock,Absentee by Mail,283,Attorney General,281,2
Hancock,Advance in Person,839,Attorney General,810,29
Hancock,Election Day,1257,Attorney General,1235,22
Hancock,Provisional,19,Attorney General,18,1
Haralson,Absentee by Mail,262,Attorney General,259,3
Haralson,Advance in Person,1563,Attorney General,1542,21
Haralson,Election Day,4986,Attorney General,4943,43
Haralson,Provisional,2,Attorney General,2,0
Harris,Absentee by Mail,493,Attorney General,488,5
Harris,Advance in Person,2950,Attorney General,2942,8
Harris,Election Day,6803,Attorney General,6789,14
Harris,Provisional,2,Attorney General,2,0
Hart,Absentee by Mail,287,Attorney General,279,8
Hart,Advance in Person,2309,Attorney General,2250,59
Hart,Election Day,4185,Attorney General,4145,40
Hart,Provisional,1,Attorney General,1,0
Heard,Absentee by Mail,157,Attorney General,154,3
Heard,Advance in Person,552,Attorney General,535,17
Heard,Election Day,1772,Attorney General,1753,19
Heard,Provisional,0,Attorney General,0,0
Henry,Absentee by Mail,2016,Attorney General,1997,19
Henry,Advance in Person,29231,Attorney General,29200,31
Henry,Election Day,31732,Attorney General,31650,82
Henry,Provisional,102,Attorney General,101,1
Houston,Absentee by Mail,1431,Attorney General,1408,23
Houston,Advance in Person,16400,Attorney General,16321,79
Houston,Election Day,19454,Attorney General,19331,123
Houston,Provisional,62,Attorney General,56,6
Irwin,Absentee by Mail,61,Attorney General,60,1
Irwin,Advance in Person,719,Attorney General,690,29
Irwin,Election Day,1581,Attorney General,1550,31
Irwin,Provisional,3,Attorney General,3,0
Jackson,Absentee by Mail,495,Attorney General,491,4
Jackson,Advance in Person,5419,Attorney General,5396,23
Jackson,Election Day,10060,Attorney General,9975,85
Jackson,Provisional,16,Attorney General,15,1
Jasper,Absentee by Mail,255,Attorney General,254,1
Jasper,Advance in Person,1280,Attorney General,1273,7
Jasper,Election Day,2305,Attorney General,2300,5
Jasper,Provisional,2,Attorney General,2,0
Jeff Davis,Absentee by Mail,153,Attorney General,145,8
Jeff Davis,Advance in Person,861,Attorney General,830,31
Jeff Davis,Election Day,1973,Attorney General,1941,32
Jeff Davis,Provisional,1,Attorney General,1,0
Jefferson,Absentee by Mail,216,Attorney General,215,1
Jefferson,Advance in Person,1158,Attorney General,1158,0
Jefferson,Election Day,3144,Attorney General,3114,30
Jefferson,Provisional,20,Attorney General,20,0
Jenkins,Absentee by Mail,163,Attorney General,162,1
Jenkins,Advance in Person,671,Attorney General,663,8
Jenkins,Election Day,1088,Attorney General,1079,9
Jenkins,Provisional,0,Attorney General,0,0
Johnson,Absentee by Mail,92,Attorney General,92,0
Johnson,Advance in Person,789,Attorney General,781,8
Johnson,Election Day,1415,Attorney General,1415,0
Johnson,Provisional,0,Attorney General,0,0
Jones,Absentee by Mail,511,Attorney General,502,9
Jones,Advance in Person,2913,Attorney General,2893,20
Jones,Election Day,4638,Attorney General,4621,17
Jones,Provisional,7,Attorney General,7,0
Lamar,Absentee by Mail,215,Attorney General,210,5
Lamar,Advance in Person,1700,Attorney General,1674,26
Lamar,Election Day,3046,Attorney General,3040,6
Lamar,Provisional,5,Attorney General,5,0
Lanier,Absentee by Mail,40,Attorney General,40,0
Lanier,Advance in Person,521,Attorney General,518,3
Lanier,Election Day,878,Attorney General,873,5
Lanier,Provisional,4,Attorney General,4,0
Laurens,Absentee by Mail,763,Attorney General,751,12
Laurens,Advance in Person,3953,Attorney General,3919,34
Laurens,Election Day,8153,Attorney General,8065,88
Laurens,Provisional,14,Attorney General,13,1
Lee,Absentee by Mail,241,Attorney General,237,4
Lee,Advance in Person,2107,Attorney General,2098,9
Lee,Election Day,6514,Attorney General,6488,26
Lee,Provisional,5,Attorney General,5,0
Liberty,Absentee by Mail,209,Attorney General,206,3
Liberty,Advance in Person,3652,Attorney General,3617,35
Liberty,Election Day,5097,Attorney General,5075,22
Liberty,Provisional,4,Attorney General,4,0
Lincoln,Absentee by Mail,222,Attorney General,219,3
Lincoln,Advance in Person,899,Attorney General,885,14
Lincoln,Election Day,1554,Attorney General,1542,12
Lincoln,Provisional,13,Attorney General,13,0
Long,Absentee by Mail,40,Attorney General,40,0
Long,Advance in Person,691,Attorney General,688,3
Long,Election Day,1397,Attorney General,1382,15
Long,Provisional,6,Attorney General,6,0
Lowndes,Absentee by Mail,532,Attorney General,524,8
Lowndes,Advance in Person,8813,Attorney General,8812,1
Lowndes,Election Day,11478,Attorney General,11439,39
Lowndes,Provisional,560,Attorney General,557,3
Lumpkin,Absentee by Mail,305,Attorney General,298,7
Lumpkin,Advance in Person,2933,Attorney General,2900,33
Lumpkin,Election Day,4404,Attorney General,4344,60
Lumpkin,Provisional,15,Attorney General,15,0
Macon,Absentee by Mail,106,Attorney General,106,0
Macon,Advance in Person,1207,Attorney General,1146,61
Macon,Election Day,1695,Attorney General,1644,51
Macon,Provisional,0,Attorney General,0,0
Madison,Absentee by Mail,312,Attorney General,301,11
Madison,Advance in Person,2257,Attorney General,2238,19
Madison,Election Day,4970,Attorney General,4887,83
Madison,Provisional,6,Attorney General,6,0
Marion,Absentee by Mail,219,Attorney General,213,6
Marion,Advance in Person,612,Attorney General,600,12
Marion,Election Day,1314,Attorney General,1293,21
Marion,Provisional,0,Attorney General,0,0
McDuffie,Absentee by Mail,351,Attorney General,347,4
McDuffie,Advance in Person,2043,Attorney General,2029,14
McDuffie,Election Day,3653,Attorney General,3624,29
McDuffie,Provisional,3,Attorney General,3,0
McIntosh,Absentee by Mail,300,Attorney General,291,9
McIntosh,Advance in Person,1300,Attorney General,1290,10
McIntosh,Election Day,2233,Attorney General,2223,10
McIntosh,Provisional,7,Attorney General,6,1
Meriwether,Absentee by Mail,207,Attorney General,203,4
Meriwether,Advance in Person,1188,Attorney General,1170,18
Meriwether,Election Day,4671,Attorney General,4590,81
Meriwether,Provisional,1,Attorney General,1,0
Miller,Absentee by Mail,53,Attorney General,52,1
Miller,Advance in Person,436,Attorney General,423,13
Miller,Election Day,937,Attorney General,927,10
Miller,Provisional,1,Attorney General,1,0
Mitchell,Absentee by Mail,202,Attorney General,199,3
Mitchell,Advance in Person,1589,Attorney General,1568,21
Mitchell,Election Day,3215,Attorney General,3190,25
Mitchell,Provisional,3,Attorney General,3,0
Monroe,Absentee by Mail,358,Attorney General,353,5
Monroe,Advance in Person,2523,Attorney General,2485,38
Monroe,Election Day,5671,Attorney General,5632,39
Monroe,Provisional,23,Attorney General,21,2
Montgomery,Absentee by Mail,92,Attorney General,90,2
Montgomery,Advance in Person,463,Attorney General,447,16
Montgomery,Election Day,1730,Attorney General,1697,33
Montgomery,Provisional,0,Attorney General,0,0
Morgan,Absentee by Mail,193,Attorney General,190,3
Morgan,Advance in Person,2475,Attorney General,2453,22
Morgan,Election Day,3635,Attorney General,3602,33
Morgan,Provisional,7,Attorney General,7,0
Murray,Absentee by Mail,207,Attorney General,193,14
Murray,Advance in Person,1347,Attorney General,1304,43
Murray,Election Day,4497,Attorney General,4375,122
Murray,Provisional,0,Attorney General,0,0
Muscogee,Absentee by Mail,2150,Attorney General,2129,21
Muscogee,Advance in Person,13494,Attorney General,13400,94
Muscogee,Election Day,25301,Attorney General,25255,46
Muscogee,Provisional,63,Attorney General,63,0
Newton,Absentee by Mail,1136,Attorney General,1117,19
Newton,Advance in Person,10430,Attorney General,10380,50
Newton,Election Day,16634,Attorney General,16594,40
Newton,Provisional,2,Attorney General,2,0
Oconee,Absentee by Mail,368,Attorney General,356,12
Oconee,Advance in Person,5438,Attorney General,5368,70
Oconee,Election Day,7726,Attorney General,7510,216
Oconee,Provisional,7,Attorney General,7,0
Oglethorpe,Absentee by Mail,217,Attorney General,215,2
Oglethorpe,Advance in Person,1609,Attorney General,1597,12
Oglethorpe,Election Day,2262,Attorney General,2240,22
Oglethorpe,Provisional,4,Attorney General,4,0
Paulding,Absentee by Mail,1789,Attorney General,1766,23
Paulding,Advance in Person,14824,Attorney General,14806,18
Paulding,Election Day,19620,Attorney General,19577,43
Paulding,Provisional,29,Attorney General,27,2
Peach,Absentee by Mail,215,Attorney General,214,1
Peach,Advance in Person,3402,Attorney General,3374,28
Peach,Election Day,3620,Attorney General,3620,0
Peach,Provisional,8,Attorney General,8,0
Pickens,Absentee by Mail,138,Attorney General,136,2
Pickens,Advance in Person,3653,Attorney General,3607,46
Pickens,Election Day,5031,Attorney General,4992,39
Pickens,Provisional,1,Attorney General,1,0
Pierce,Absentee by Mail,228,Attorney General,224,4
Pierce,Advance in Person,1629,Attorney General,1601,28
Pierce,Election Day,2106,Attorney General,2093,13
Pierce,Provisional,0,Attorney General,0,0
Pike,Absentee by Mail,246,Attorney General,237,9
Pike,Advance in Person,1650,Attorney General,1647,3
Pike,Election Day,3700,Attorney General,3680,20
Pike,Provisional,8,Attorney General,8,0
Polk,Absentee by Mail,235,Attorney General,231,4
Polk,Advance in Person,3214,Attorney General,3185,29
Polk,Election Day,4537,Attorney General,4482,55
Polk,Provisional,4,Attorney General,4,0
Pulaski,Absentee by Mail,86,Attorney General,84,2
Pulaski,Advance in Person,1249,Attorney General,1227,22
Pulaski,Election Day,1013,Attorney General,983,30
Pulaski,Provisional,2,Attorney General,2,0
Putnam,Absentee by Mail,387,Attorney General,383,4
Putnam,Advance in Person,2434,Attorney General,2414,20
Putnam,Election Day,3451,Attorney General,3431,20
Putnam,Provisional,2,Attorney General,2,0
Quitman,Absentee by Mail,41,Attorney General,41,0
Quitman,Advance in Person,209,Attorney General,207,2
Quitman,Election Day,347,Attorney General,338,9
Quitman,Provisional,1,Attorney General,1,0
Rabun,Absentee by Mail,427,Attorney General,412,15
Rabun,Advance in Person,3295,Attorney General,3190,105
Rabun,Election Day,1731,Attorney General,1670,61
Rabun,Provisional,0,Attorney General,0,0
Randolph,Absentee by Mail,149,Attorney General,143,6
Randolph,Advance in Person,789,Attorney General,772,17
Randolph,Election Day,1173,Attorney General,1154,19
Randolph,Provisional,7,Attorney General,7,0
Richmond,Absentee by Mail,3207,Attorney General,3171,36
Richmond,Advance in Person,13314,Attorney General,13214,100
Richmond,Election Day,31248,Attorney General,31061,187
Richmond,Provisional,71,Attorney General,71,0
Rockdale,Absentee by Mail,825,Attorney General,806,19
Rockdale,Advance in Person,13442,Attorney General,13381,61
Rockdale,Election Day,12256,Attorney General,12227,29
Rockdale,Provisional,48,Attorney General,48,0
Schley,Absentee by Mail,66,Attorney General,64,2
Schley,Advance in Person,602,Attorney General,592,10
Schley,Election Day,595,Attorney General,586,9
Schley,Provisional,3,Attorney General,3,0
Screven,Absentee by Mail,158,Attorney General,152,6
Screven,Advance in Person,1201,Attorney General,1182,19
Screven,Election Day,2412,Attorney General,2391,21
Screven,Provisional,4,Attorney General,4,0
Seminole,Absentee by Mail,76,Attorney General,76,0
Seminole,Advance in Person,477,Attorney General,467,10
Seminole,Election Day,1698,Attorney General,1670,28
Seminole,Provisional,5,Attorney General,5,0
Spalding,Absentee by Mail,528,Attorney General,513,15
Spalding,Advance in Person,6771,Attorney General,6686,85
Spalding,Election Day,9378,Attorney General,9274,104
Spalding,Provisional,14,Attorney General,14,0
Stephens,Absentee by Mail,337,Attorney General,331,6
Stephens,Advance in Person,2604,Attorney General,2575,29
Stephens,Election Day,2225,Attorney General,2206,19
Stephens,Provisional,2,Attorney General,2,0
Stewart,Absentee by Mail,75,Attorney General,73,2
Stewart,Advance in Person,311,Attorney General,287,24
Stewart,Election Day,808,Attorney General,783,25
Stewart,Provisional,18,Attorney General,18,0
Sumter,Absentee by Mail,522,Attorney General,519,3
Sumter,Advance in Person,3280,Attorney General,3246,34
Sumter,Election Day,4191,Attorney General,4135,56
Sumter,Provisional,5,Attorney General,5,0
Talbot,Absentee by Mail,215,Attorney General,203,12
Talbot,Advance in Person,342,Attorney General,335,7
Talbot,Election Day,1588,Attorney General,1552,36
Talbot,Provisional,2,Attorney General,1,1
Taliaferro,Absentee by Mail,50,Attorney General,48,2
Taliaferro,Advance in Person,197,Attorney General,192,5
Taliaferro,Election Day,311,Attorney General,309,2
Taliaferro,Provisional,0,Attorney General,0,0
Tattnall,Absentee by Mail,198,Attorney General,193,5
Tattnall,Advance in Person,1310,Attorney General,1285,25
Tattnall,Election Day,2706,Attorney General,2660,46
Tattnall,Provisional,6,Attorney General,5,1
Taylor,Absentee by Mail,127,Attorney General,127,0
Taylor,Advance in Person,620,Attorney General,608,12
Taylor,Election Day,1441,Attorney General,1416,25
Taylor,Provisional,0,Attorney General,0,0
Telfair,Absentee by Mail,227,Attorney General,227,0
Telfair,Advance in Person,751,Attorney General,727,24
Telfair,Election Day,1723,Attorney General,1686,37
Telfair,Provisional,0,Attorney General,0,0
Terrell,Absentee by Mail,258,Attorney General,238,20
Terrell,Advance in Person,1101,Attorney General,1071,30
Terrell,Election Day,1887,Attorney General,1858,29
Terrell,Provisional,2,Attorney General,2,0
Thomas,Absentee by Mail,293,Attorney General,288,5
Thomas,Advance in Person,3653,Attorney General,3642,11
Thomas,Election Day,7055,Attorney General,7015,40
Thomas,Provisional,2,Attorney General,2,0
Tift,Absentee by Mail,254,Attorney General,250,4
Tift,Advance in Person,3128,Attorney General,3093,35
Tift,Election Day,5030,Attorney General,4954,76
Tift,Provisional,92,Attorney General,88,4
Toombs,Absentee by Mail,381,Attorney General,378,3
Toombs,Advance in Person,1805,Attorney General,1778,27
Toombs,Election Day,3352,Attorney General,3334,18
Toombs,Provisional,6,Attorney General,6,0
Towns,Absentee by Mail,190,Attorney General,184,6
Towns,Advance in Person,2289,Attorney General,2247,42
Towns,Election Day,1717,Attorney General,1694,23
Towns,Provisional,68,Attorney General,65,3
Treutlen,Absentee by Mail,50,Attorney General,49,1
Treutlen,Advance in Person,426,Attorney General,418,8
Treutlen,Election Day,1041,Attorney General,1028,13
Treutlen,Provisional,3,Attorney General,3,0
Troup,Absentee by Mail,847,Attorney General,832,15
Troup,Advance in Person,4821,Attorney General,4802,19
Troup,Election Day,9963,Attorney General,9907,56
Troup,Provisional,41,Attorney General,39,2
Turner,Absentee by Mail,41,Attorney General,39,2
Turner,Advance in Person,1026,Attorney General,1013,13
Turner,Election Day,1188,Attorney General,1170,18
Turner,Provisional,11,Attorney General,11,0
Twiggs,Absentee by Mail,275,Attorney General,271,4
Twiggs,Advance in Person,841,Attorney General,825,16
Twiggs,Election Day,1776,Attorney General,1755,21
Twiggs,Provisional,1,Attorney General,1,0
Union,Absentee by Mail,288,Attorney General,277,11
Union,Advance in Person,3487,Attorney General,3443,44
Union,Election Day,3966,Attorney General,3898,68
Union,Provisional,2,Attorney General,2,0
Upson,Absentee by Mail,230,Attorney General,223,7
Upson,Advance in Person,2400,Attorney General,2366,34
Upson,Election Day,4440,Attorney General,4414,26
Upson,Provisional,1,Attorney General,1,0
Walker,Absentee by Mail,617,Attorney General,601,16
Walker,Advance in Person,3646,Attorney General,3603,43
Walker,Election Day,8076,Attorney General,8003,73
Walker,Provisional,0,Attorney General,0,0
Walton,Absentee by Mail,1068,Attorney General,1043,25
Walton,Advance in Person,6096,Attorney General,6067,29
Walton,Election Day,18659,Attorney General,18494,165
Walton,Provisional,16,Attorney General,16,0
Ware,Absentee by Mail,326,Attorney General,321,5
Ware,Advance in Person,2081,Attorney General,2051,30
Ware,Election Day,4306,Attorney General,4249,57
Ware,Provisional,1,Attorney General,1,0
Warren,Absentee by Mail,60,Attorney General,59,1
Warren,Advance in Person,543,Attorney General,528,15
Warren,Election Day,889,Attorney General,872,17
Warren,Provisional,1,Attorney General,1,0
Washington,Absentee by Mail,355,Attorney General,351,4
Washington,Advance in Person,2324,Attorney General,2274,50
Washington,Election Day,3362,Attorney General,3273,89
Washington,Provisional,8,Attorney General,7,1
Wayne,Absentee by Mail,258,Attorney General,246,12
Wayne,Advance in Person,2152,Attorney General,2121,31
Wayne,Election Day,3740,Attorney General,3700,40
Wayne,Provisional,0,Attorney General,0,0
Webster,Absentee by Mail,80,Attorney General,74,6
Webster,Advance in Person,271,Attorney General,265,6
Webster,Election Day,426,Attorney General,409,17
Webster,Provisional,0,Attorney General,0,0
Wheeler,Absentee by Mail,87,Attorney General,84,3
Wheeler,Advance in Person,447,Attorney General,432,15
Wheeler,Election Day,959,Attorney General,945,14
Wheeler,Provisional,9,Attorney General,8,1
White,Absentee by Mail,447,Attorney General,432,15
White,Advance in Person,2267,Attorney General,2245,22
White,Election Day,4948,Attorney General,4881,67
White,Provisional,3,Attorney General,3,0
Whitfield,Absentee by Mail,478,Attorney General,468,10
Whitfield,Advance in Person,3511,Attorney General,3458,53
Whitfield,Election Day,11767,Attorney General,11551,216
Whitfield,Provisional,38,Attorney General,38,0
Wilcox,Absentee by Mail,144,Attorney General,142,2
Wilcox,Advance in Person,455,Attorney General,449,6
Wilcox,Election Day,1280,Attorney General,1267,13
Wilcox,Provisional,3,Attorney General,3,0
Wilkes,Absentee by Mail,104,Attorney General,103,1
Wilkes,Advance in Person,939,Attorney General,918,21
Wilkes,Election Day,2044,Attorney General,2030,14
Wilkes,Provisional,3,Attorney General,3,0
Wilkinson,Absentee by Mail,150,Attorney General,147,3
Wilkinson,Advance in Person,763,Attorney General,745,18
Wilkinson,Election Day,2227,Attorney General,2188,39
Wilkinson,Provisional,1,Attorney General,1,0
Worth,Absentee by Mail,138,Attorney General,137,1
Worth,Advance in Person,1170,Attorney General,1170,0
Worth,Election Day,3871,Attorney General,3858,13
Worth,Provisional,10,Attorney General,10,0
Appling,Absentee by Mail,306,Commissioner Of Agriculture,304,2
Appling,Advance in Person,976,Commissioner Of Agriculture,961,15
Appling,Election Day,3122,Commissioner Of Agriculture,3104,18
Appling,Provisional,4,Commissioner Of Agriculture,4,0
Atkinson,Absentee by Mail,68,Commissioner Of Agriculture,67,1
Atkinson,Advance in Person,495,Commissioner Of Agriculture,485,10
Atkinson,Election Day,1058,Commissioner Of Agriculture,1013,45
Atkinson,Provisional,7,Commissioner Of Agriculture,7,0
Bacon,Absentee by Mail,73,Commissioner Of Agriculture,72,1
Bacon,Advance in Person,887,Commissioner Of Agriculture,876,11
Bacon,Election Day,1240,Commissioner Of Agriculture,1232,8
Bacon,Provisional,3,Commissioner Of Agriculture,3,0
Baker,Absentee by Mail,71,Commissioner Of Agriculture,69,2
Baker,Advance in Person,298,Commissioner Of Agriculture,296,2
Baker,Election Day,617,Commissioner Of Agriculture,616,1
Baker,Provisional,3,Commissioner Of Agriculture,3,0
Baldwin,Absentee by Mail,409,Commissioner Of Agriculture,403,6
Baldwin,Advance in Person,3933,Commissioner Of Agriculture,3863,70
Baldwin,Election Day,6152,Commissioner Of Agriculture,6119,33
Baldwin,Provisional,9,Commissioner Of Agriculture,9,0
Banks,Absentee by Mail,142,Commissioner Of Agriculture,139,3
Banks,Advance in Person,852,Commissioner Of Agriculture,847,5
Banks,Election Day,3339,Commissioner Of Agriculture,3320,19
Banks,Provisional,1,Commissioner Of Agriculture,0,1
Barrow,Absentee by Mail,701,Commissioner Of Agriculture,693,8
Barrow,Advance in Person,4720,Commissioner Of Agriculture,4703,17
Barrow,Election Day,10688,Commissioner Of Agriculture,10591,97
Barrow,Provisional,8,Commissioner Of Agriculture,7,1
Bartow,Absentee by Mail,772,Commissioner Of Agriculture,763,9
Bartow,Advance in Person,5826,Commissioner Of Agriculture,5777,49
Bartow,Election Day,16152,Commissioner Of Agriculture,15985,167
Bartow,Provisional,20,Commissioner Of Agriculture,20,0
Ben Hill,Absentee by Mail,136,Commissioner Of Agriculture,129,7
Ben Hill,Advance in Person,1494,Commissioner Of Agriculture,1477,17
Ben Hill,Election Day,1864,Commissioner Of Agriculture,1842,22
Ben Hill,Provisional,3,Commissioner Of Agriculture,3,0
Berrien,Absentee by Mail,212,Commissioner Of Agriculture,210,2
Berrien,Advance in Person,1103,Commissioner Of Agriculture,1098,5
Berrien,Election Day,2608,Commissioner Of Agriculture,2600,8
Berrien,Provisional,8,Commissioner Of Agriculture,8,0
Bibb,Absentee by Mail,2189,Commissioner Of Agriculture,2142,47
Bibb,Advance in Person,10315,Commissioner Of Agriculture,10167,148
Bibb,Election Day,29989,Commissioner Of Agriculture,29434,555
Bibb,Provisional,78,Commissioner Of Agriculture,76,2
Bleckley,Absentee by Mail,228,Commissioner Of Agriculture,220,8
Bleckley,Advance in Person,1157,Commissioner Of Agriculture,1143,14
Bleckley,Election Day,1855,Commissioner Of Agriculture,1837,18
Bleckley,Provisional,5,Commissioner Of Agriculture,5,0
Brantley,Absentee by Mail,143,Commissioner Of Agriculture,142,1
Brantley,Advance in Person,747,Commissioner Of Agriculture,735,12
Brantley,Election Day,2086,Commissioner Of Agriculture,2066,20
Brantley,Provisional,4,Commissioner Of Agriculture,4,0
Brooks,Absentee by Mail,1016,Commissioner Of Agriculture,1007,9
Brooks,Advance in Person,1259,Commissioner Of Agriculture,1259,0
Brooks,Election Day,2355,Commissioner Of Agriculture,2355,0
Brooks,Provisional,26,Commissioner Of Agriculture,25,1
Bryan,Absentee by Mail,237,Commissioner Of Agriculture,226,11
Bryan,Advance in Person,2852,Commissioner Of Agriculture,2817,35
Bryan,Election Day,4863,Commissioner Of Agriculture,4813,50
Bryan,Provisional,3,Commissioner Of Agriculture,3,0
Bulloch,Absentee by Mail,541,Commissioner Of Agriculture,534,7
Bulloch,Advance in Person,3846,Commissioner Of Agriculture,3820,26
Bulloch,Election Day,9455,Commissioner Of Agriculture,9336,119
Bulloch,Provisional,12,Commissioner Of Agriculture,11,1
Burke,Absentee by Mail,594,Commissioner Of Agriculture,589,5
Burke,Advance in Person,1260,Commissioner Of Agriculture,1242,18
Burke,Election Day,4049,Commissioner Of Agriculture,3998,51
Burke,Provisional,0,Commissioner Of Agriculture,0,0
Butts,Absentee by Mail,183,Commissioner Of Agriculture,180,3
Butts,Advance in Person,3252,Commissioner Of Agriculture,3226,26
Butts,Election Day,2671,Commissioner Of Agriculture,2653,18
Butts,Provisional,0,Commissioner Of Agriculture,0,0
Calhoun,Absentee by Mail,91,Commissioner Of Agriculture,91,0
Calhoun,Advance in Person,320,Commissioner Of Agriculture,316,4
Calhoun,Election Day,1044,Commissioner Of Agriculture,1035,9
Calhoun,Provisional,2,Commissioner Of Agriculture,2,0
Camden,Absentee by Mail,586,Commissioner Of Agriculture,581,5
Camden,Advance in Person,2509,Commissioner Of Agriculture,2478,31
Camden,Election Day,6720,Commissioner Of Agriculture,6647,73
Camden,Provisional,9,Commissioner Of Agriculture,9,0
Candler,Absentee by Mail,108,Commissioner Of Agriculture,106,2
Candler,Advance in Person,835,Commissioner Of Agriculture,829,6
Candler,Election Day,1258,Commissioner Of Agriculture,1247,11
Candler,Provisional,0,Commissioner Of Agriculture,0,0
Carroll,Absentee by Mail,845,Commissioner Of Agriculture,835,10
Carroll,Advance in Person,7673,Commissioner Of Agriculture,7591,82
Carroll,Election Day,17495,Commissioner Of Agriculture,17377,118
Carroll,Provisional,53,Commissioner Of Agriculture,52,1
Catoosa,Absentee by Mail,456,Commissioner Of Agriculture,443,13
Catoosa,Advance in Person,4909,Commissioner Of Agriculture,4854,55
Catoosa,Election Day,8541,Commissioner Of Agriculture,8416,125
Catoosa,Provisional,14,Commissioner Of Agriculture,14,0
Charlton,Absentee by Mail,80,Commissioner Of Agriculture,80,0
Charlton,Advance in Person,684,Commissioner Of Agriculture,684,0
Charlton,Election Day,1247,Commissioner Of Agriculture,1235,12
Charlton,Provisional,4,Commissioner Of Agriculture,4,0
Chatham,Absentee by Mail,2948,Commissioner Of Agriculture,2855,93
Chatham,Advance in Person,17241,Commissioner Of Agriculture,17072,169
Chatham,Election Day,48480,Commissioner Of Agriculture,47793,687
Chatham,Provisional,55,Commissioner Of Agriculture,54,1
Chattahoochee,Absentee by Mail,22,Commissioner Of Agriculture,22,0
Chattahoochee,Advance in Person,196,Commissioner Of Agriculture,192,4
Chattahoochee,Election Day,481,Commissioner Of Agriculture,474,7
Chattahoochee,Provisional,2,Commissioner Of Agriculture,2,0
Chattooga,Absentee by Mail,107,Commissioner Of Agriculture,103,4
Chattooga,Advance in Person,1625,Commissioner Of Agriculture,1587,38
Chattooga,Election Day,3090,Commissioner Of Agriculture,3050,40
Chattooga,Provisional,2,Commissioner Of Agriculture,2,0
Cherokee,Absentee by Mail,2440,Commissioner Of Agriculture,2356,84
Cherokee,Advance in Person,23437,Commissioner Of Agriculture,22985,452
Cherokee,Election Day,40811,Commissioner Of Agriculture,39997,814
Cherokee,Provisional,31,Commissioner Of Agriculture,29,2
Clarke,Absentee by Mail,1152,Commissioner Of Agriculture,1117,35
Clarke,Advance in Person,7332,Commissioner Of Agriculture,7177,155
Clarke,Election Day,16976,Commissioner Of Agriculture,16529,447
Clarke,Provisional,76,Commissioner Of Agriculture,70,6
Clay,Absentee by Mail,90,Commissioner Of Agriculture,86,4
Clay,Advance in Person,244,Commissioner Of Agriculture,241,3
Clay,Election Day,602,Commissioner Of Agriculture,595,7
Clay,Provisional,1,Commissioner Of Agriculture,1,0
Clayton,Absentee by Mail,1772,Commissioner Of Agriculture,1742,30
Clayton,Advance in Person,25878,Commissioner Of Agriculture,25571,307
Clayton,Election Day,34794,Commissioner Of Agriculture,34422,372
Clayton,Provisional,66,Commissioner Of Agriculture,63,3
Clinch,Absentee by Mail,53,Commissioner Of Agriculture,50,3
Clinch,Advance in Person,340,Commissioner Of Agriculture,336,4
Clinch,Election Day,777,Commissioner Of Agriculture,777,0
Clinch,Provisional,2,Commissioner Of Agriculture,2,0
Cobb,Absentee by Mail,10616,Commissioner Of Agriculture,10273,343
Cobb,Advance in Person,58755,Commissioner Of Agriculture,57739,1016
Cobb,Election Day,143123,Commissioner Of Agriculture,139610,3513
Cobb,Provisional,581,Commissioner Of Agriculture,559,22
Coffee,Absentee by Mail,328,Commissioner Of Agriculture,325,3
Coffee,Advance in Person,3477,Commissioner Of Agriculture,3452,25
Coffee,Election Day,4390,Commissioner Of Agriculture,4342,48
Coffee,Provisional,7,Commissioner Of Agriculture,7,0
Colquitt,Absentee by Mail,172,Commissioner Of Agriculture,169,3
Colquitt,Advance in Person,2409,Commissioner Of Agriculture,2400,9
Colquitt,Election Day,5359,Commissioner Of Agriculture,5351,8
Colquitt,Provisional,4,Commissioner Of Agriculture,4,0
Columbia,Absentee by Mail,1698,Commissioner Of Agriculture,1666,32
Columbia,Advance in Person,11710,Commissioner Of Agriculture,11624,86
Columbia,Election Day,26403,Commissioner Of Agriculture,26190,213
Columbia,Provisional,10,Commissioner Of Agriculture,10,0
Cook,Absentee by Mail,113,Commissioner Of Agriculture,112,1
Cook,Advance in Person,1115,Commissioner Of Agriculture,1115,0
Cook,Election Day,2316,Commissioner Of Agriculture,2305,11
Cook,Provisional,0,Commissioner Of Agriculture,0,0
Coweta,Absentee by Mail,1733,Commissioner Of Agriculture,1699,34
Coweta,Advance in Person,9167,Commissioner Of Agriculture,9068,99
Coweta,Election Day,26256,Commissioner Of Agriculture,25984,272
Coweta,Provisional,15,Commissioner Of Agriculture,15,0
Crawford,Absentee by Mail,146,Commissioner Of Agriculture,145,1
Crawford,Advance in Person,1092,Commissioner Of Agriculture,1063,29
Crawford,Election Day,2012,Commissioner Of Agriculture,1987,25
Crawford,Provisional,4,Commissioner Of Agriculture,4,0
Crisp,Absentee by Mail,169,Commissioner Of Agriculture,164,5
Crisp,Advance in Person,2060,Commissioner Of Agriculture,2041,19
Crisp,Election Day,2752,Commissioner Of Agriculture,2716,36
Crisp,Provisional,2,Commissioner Of Agriculture,2,0
Dade,Absentee by Mail,114,Commissioner Of Agriculture,109,5
Dade,Advance in Person,1030,Commissioner Of Agriculture,996,34
Dade,Election Day,2283,Commissioner Of Agriculture,2207,76
Dade,Provisional,9,Commissioner Of Agriculture,9,0
Dawson,Absentee by Mail,311,Commissioner Of Agriculture,305,6
Dawson,Advance in Person,3231,Commissioner Of Agriculture,3183,48
Dawson,Election Day,3731,Commissioner Of Agriculture,3680,51
Dawson,Provisional,11,Commissioner Of Agriculture,10,1
DeKalb,Absentee by Mail,8280,Commissioner Of Agriculture,7888,392
DeKalb,Advance in Person,72480,Commissioner Of Agriculture,70884,1596
DeKalb,Election Day,129376,Commissioner Of Agriculture,125560,3816
DeKalb,Provisional,503,Commissioner Of Agriculture,477,26
Decatur,Absentee by Mail,269,Commissioner Of Agriculture,262,7
Decatur,Advance in Person,1985,Commissioner Of Agriculture,1978,7
Decatur,Election Day,3820,Commissioner Of Agriculture,3780,40
Decatur,Provisional,5,Commissioner Of Agriculture,4,1
Dodge,Absentee by Mail,219,Commissioner Of Agriculture,216,3
Dodge,Advance in Person,1690,Commissioner Of Agriculture,1662,28
Dodge,Election Day,3173,Commissioner Of Agriculture,3143,30
Dodge,Provisional,0,Commissioner Of Agriculture,0,0
Dooly,Absentee by Mail,68,Commissioner Of Agriculture,66,2
Dooly,Advance in Person,834,Commissioner Of Agriculture,808,26
Dooly,Election Day,1783,Commissioner Of Agriculture,1752,31
Dooly,Provisional,0,Commissioner Of Agriculture,0,0
Dougherty,Absentee by Mail,1050,Commissioner Of Agriculture,1038,12
Dougherty,Advance in Person,6272,Commissioner Of Agriculture,6153,119
Dougherty,Election Day,16148,Commissioner Of Agriculture,15973,175
Dougherty,Provisional,41,Commissioner Of Agriculture,40,1
Douglas,Absentee by Mail,1308,Commissioner Of Agriculture,1282,26
Douglas,Advance in Person,15797,Commissioner Of Agriculture,15648,149
Douglas,Election Day,20398,Commissioner Of Agriculture,20270,128
Douglas,Provisional,27,Commissioner Of Agriculture,27,0
Early,Absentee by Mail,140,Commissioner Of Agriculture,135,5
Early,Advance in Person,890,Commissioner Of Agriculture,877,13
Early,Election Day,2163,Commissioner Of Agriculture,2163,0
Early,Provisional,3,Commissioner Of Agriculture,3,0
Echols,Absentee by Mail,19,Commissioner Of Agriculture,19,0
Echols,Advance in Person,243,Commissioner Of Agriculture,243,0
Echols,Election Day,361,Commissioner Of Agriculture,357,4
Echols,Provisional,0,Commissioner Of Agriculture,0,0
Effingham,Absentee by Mail,373,Commissioner Of Agriculture,362,11
Effingham,Advance in Person,3036,Commissioner Of Agriculture,3024,12
Effingham,Election Day,9204,Commissioner Of Agriculture,9123,81
Effingham,Provisional,10,Commissioner Of Agriculture,10,0
Elbert,Absentee by Mail,219,Commissioner Of Agriculture,217,2
Elbert,Advance in Person,1841,Commissioner Of Agriculture,1829,12
Elbert,Election Day,2632,Commissioner Of Agriculture,2615,17
Elbert,Provisional,11,Commissioner Of Agriculture,11,0
Emanuel,Absentee by Mail,213,Commissioner Of Agriculture,205,8
Emanuel,Advance in Person,1187,Commissioner Of Agriculture,1156,31
Emanuel,Election Day,3581,Commissioner Of Agriculture,3518,63
Emanuel,Provisional,1,Commissioner Of Agriculture,1,0
Evans,Absentee by Mail,122,Commissioner Of Agriculture,118,4
Evans,Advance in Person,921,Commissioner Of Agriculture,906,15
Evans,Election Day,1107,Commissioner Of Agriculture,1091,16
Evans,Provisional,0,Commissioner Of Agriculture,0,0
Fannin,Absentee by Mail,417,Commissioner Of Agriculture,410,7
Fannin,Advance in Person,2268,Commissioner Of Agriculture,2228,40
Fannin,Election Day,4216,Commissioner Of Agriculture,4133,83
Fannin,Provisional,3,Commissioner Of Agriculture,2,1
Fayette,Absentee by Mail,1272,Commissioner Of Agriculture,1236,36
Fayette,Advance in Person,18189,Commissioner Of Agriculture,17858,331
Fayette,Election Day,22606,Commissioner Of Agriculture,22201,405
Fayette,Provisional,13,Commissioner Of Agriculture,13,0
Floyd,Absentee by Mail,771,Commissioner Of Agriculture,750,21
Floyd,Advance in Person,5763,Commissioner Of Agriculture,5677,86
Floyd,Election Day,14210,Commissioner Of Agriculture,14015,195
Floyd,Provisional,78,Commissioner Of Agriculture,75,3
Forsyth,Absentee by Mail,1655,Commissioner Of Agriculture,1595,60
Forsyth,Advance in Person,22647,Commissioner Of Agriculture,22254,393
Forsyth,Election Day,32220,Commissioner Of Agriculture,31694,526
Forsyth,Provisional,48,Commissioner Of Agriculture,45,3
Franklin,Absentee by Mail,198,Commissioner Of Agriculture,192,6
Franklin,Advance in Person,1077,Commissioner Of Agriculture,1077,0
Franklin,Election Day,3454,Commissioner Of Agriculture,3447,7
Franklin,Provisional,1,Commissioner Of Agriculture,1,0
Fulton,Absentee by Mail,8864,Commissioner Of Agriculture,8522,342
Fulton,Advance in Person,87201,Commissioner Of Agriculture,85086,2115
Fulton,Election Day,167468,Commissioner Of Agriculture,162594,4874
Fulton,Provisional,2135,Commissioner Of Agriculture,2037,98
Gilmer,Absentee by Mail,378,Commissioner Of Agriculture,375,3
Gilmer,Advance in Person,2578,Commissioner Of Agriculture,2528,50
Gilmer,Election Day,4854,Commissioner Of Agriculture,4769,85
Gilmer,Provisional,16,Commissioner Of Agriculture,16,0
Glascock,Absentee by Mail,36,Commissioner Of Agriculture,34,2
Glascock,Advance in Person,211,Commissioner Of Agriculture,209,2
Glascock,Election Day,542,Commissioner Of Agriculture,533,9
Glascock,Provisional,0,Commissioner Of Agriculture,0,0
Glynn,Absentee by Mail,883,Commissioner Of Agriculture,869,14
Glynn,Advance in Person,7098,Commissioner Of Agriculture,6992,106
Glynn,Election Day,12102,Commissioner Of Agriculture,11930,172
Glynn,Provisional,36,Commissioner Of Agriculture,35,1
Gordon,Absentee by Mail,370,Commissioner Of Agriculture,363,7
Gordon,Advance in Person,2666,Commissioner Of Agriculture,2596,70
Gordon,Election Day,7273,Commissioner Of Agriculture,7143,130
Gordon,Provisional,16,Commissioner Of Agriculture,14,2
Grady,Absentee by Mail,157,Commissioner Of Agriculture,155,2
Grady,Advance in Person,1854,Commissioner Of Agriculture,1830,24
Grady,Election Day,3548,Commissioner Of Agriculture,3514,34
Grady,Provisional,6,Commissioner Of Agriculture,6,0
Greene,Absentee by Mail,538,Commissioner Of Agriculture,528,10
Greene,Advance in Person,3068,Commissioner Of Agriculture,3044,24
Greene,Election Day,2907,Commissioner Of Agriculture,2860,47
Greene,Provisional,10,Commissioner Of Agriculture,10,0
Gwinnett,Absentee by Mail,8170,Commissioner Of Agriculture,7954,216
Gwinnett,Advance in Person,47244,Commissioner Of Agriculture,46531,713
Gwinnett,Election Day,141636,Commissioner Of Agriculture,139164,2472
Gwinnett,Provisional,1155,Commissioner Of Agriculture,1123,32
Habersham,Absentee by Mail,704,Commissioner Of Agriculture,698,6
Habersham,Advance in Person,5381,Commissioner Of Agriculture,5305,76
Habersham,Election Day,3529,Commissioner Of Agriculture,3507,22
Habersham,Provisional,34,Commissioner Of Agriculture,31,3
Hall,Absentee by Mail,2074,Commissioner Of Agriculture,2024,50
Hall,Advance in Person,12299,Commissioner Of Agriculture,12082,217
Hall,Election Day,29428,Commissioner Of Agriculture,28990,438
Hall,Provisional,42,Commissioner Of Agriculture,41,1
Hancock,Absentee by Mail,283,Commissioner Of Agriculture,277,6
Hancock,Advance in Person,839,Commissioner Of Agriculture,806,33
Hancock,Election Day,1257,Commissioner Of Agriculture,1239,18
Hancock,Provisional,19,Commissioner Of Agriculture,17,2
Haralson,Absentee by Mail,262,Commissioner Of Agriculture,259,3
Haralson,Advance in Person,1563,Commissioner Of Agriculture,1545,18
Haralson,Election Day,4986,Commissioner Of Agriculture,4958,28
Haralson,Provisional,2,Commissioner Of Agriculture,2,0
Harris,Absentee by Mail,493,Commissioner Of Agriculture,484,9
Harris,Advance in Person,2950,Commissioner Of Agriculture,2760,190
Harris,Election Day,6803,Commissioner Of Agriculture,6753,50
Harris,Provisional,2,Commissioner Of Agriculture,2,0
Hart,Absentee by Mail,287,Commissioner Of Agriculture,282,5
Hart,Advance in Person,2309,Commissioner Of Agriculture,2248,61
Hart,Election Day,4185,Commissioner Of Agriculture,4155,30
Hart,Provisional,1,Commissioner Of Agriculture,1,0
Heard,Absentee by Mail,157,Commissioner Of Agriculture,155,2
Heard,Advance in Person,552,Commissioner Of Agriculture,541,11
Heard,Election Day,1772,Commissioner Of Agriculture,1745,27
Heard,Provisional,0,Commissioner Of Agriculture,0,0
Henry,Absentee by Mail,2016,Commissioner Of Agriculture,1991,25
Henry,Advance in Person,29231,Commissioner Of Agriculture,28958,273
Henry,Election Day,31732,Commissioner Of Agriculture,31467,265
Henry,Provisional,102,Commissioner Of Agriculture,102,0
Houston,Absentee by Mail,1431,Commissioner Of Agriculture,1400,31
Houston,Advance in Person,16400,Commissioner Of Agriculture,16256,144
Houston,Election Day,19454,Commissioner Of Agriculture,19269,185
Houston,Provisional,62,Commissioner Of Agriculture,56,6
Irwin,Absentee by Mail,61,Commissioner Of Agriculture,60,1
Irwin,Advance in Person,719,Commissioner Of Agriculture,701,18
Irwin,Election Day,1581,Commissioner Of Agriculture,1566,15
Irwin,Provisional,3,Commissioner Of Agriculture,2,1
Jackson,Absentee by Mail,495,Commissioner Of Agriculture,491,4
Jackson,Advance in Person,5419,Commissioner Of Agriculture,5378,41
Jackson,Election Day,10060,Commissioner Of Agriculture,10023,37
Jackson,Provisional,16,Commissioner Of Agriculture,14,2
Jasper,Absentee by Mail,255,Commissioner Of Agriculture,251,4
Jasper,Advance in Person,1280,Commissioner Of Agriculture,1267,13
Jasper,Election Day,2305,Commissioner Of Agriculture,2296,9
Jasper,Provisional,2,Commissioner Of Agriculture,2,0
Jeff Davis,Absentee by Mail,153,Commissioner Of Agriculture,149,4
Jeff Davis,Advance in Person,861,Commissioner Of Agriculture,847,14
Jeff Davis,Election Day,1973,Commissioner Of Agriculture,1930,43
Jeff Davis,Provisional,1,Commissioner Of Agriculture,1,0
Jefferson,Absentee by Mail,216,Commissioner Of Agriculture,214,2
Jefferson,Advance in Person,1158,Commissioner Of Agriculture,1149,9
Jefferson,Election Day,3144,Commissioner Of Agriculture,3109,35
Jefferson,Provisional,20,Commissioner Of Agriculture,20,0
Jenkins,Absentee by Mail,163,Commissioner Of Agriculture,162,1
Jenkins,Advance in Person,671,Commissioner Of Agriculture,669,2
Jenkins,Election Day,1088,Commissioner Of Agriculture,1072,16
Jenkins,Provisional,0,Commissioner Of Agriculture,0,0
Johnson,Absentee by Mail,92,Commissioner Of Agriculture,91,1
Johnson,Advance in Person,789,Commissioner Of Agriculture,777,12
Johnson,Election Day,1415,Commissioner Of Agriculture,1412,3
Johnson,Provisional,0,Commissioner Of Agriculture,0,0
Jones,Absentee by Mail,511,Commissioner Of Agriculture,500,11
Jones,Advance in Person,2913,Commissioner Of Agriculture,2884,29
Jones,Election Day,4638,Commissioner Of Agriculture,4603,35
Jones,Provisional,7,Commissioner Of Agriculture,7,0
Lamar,Absentee by Mail,215,Commissioner Of Agriculture,210,5
Lamar,Advance in Person,1700,Commissioner Of Agriculture,1673,27
Lamar,Election Day,3046,Commissioner Of Agriculture,3035,11
Lamar,Provisional,5,Commissioner Of Agriculture,5,0
Lanier,Absentee by Mail,40,Commissioner Of Agriculture,39,1
Lanier,Advance in Person,521,Commissioner Of Agriculture,511,10
Lanier,Election Day,878,Commissioner Of Agriculture,862,16
Lanier,Provisional,4,Commissioner Of Agriculture,4,0
Laurens,Absentee by Mail,763,Commissioner Of Agriculture,755,8
Laurens,Advance in Person,3953,Commissioner Of Agriculture,3907,46
Laurens,Election Day,8153,Commissioner Of Agriculture,8042,111
Laurens,Provisional,14,Commissioner Of Agriculture,13,1
Lee,Absentee by Mail,241,Commissioner Of Agriculture,236,5
Lee,Advance in Person,2107,Commissioner Of Agriculture,2092,15
Lee,Election Day,6514,Commissioner Of Agriculture,6472,42
Lee,Provisional,5,Commissioner Of Agriculture,5,0
Liberty,Absentee by Mail,209,Commissioner Of Agriculture,205,4
Liberty,Advance in Person,3652,Commissioner Of Agriculture,3589,63
Liberty,Election Day,5097,Commissioner Of Agriculture,5039,58
Liberty,Provisional,4,Commissioner Of Agriculture,4,0
Lincoln,Absentee by Mail,222,Commissioner Of Agriculture,219,3
Lincoln,Advance in Person,899,Commissioner Of Agriculture,888,11
Lincoln,Election Day,1554,Commissioner Of Agriculture,1535,19
Lincoln,Provisional,13,Commissioner Of Agriculture,13,0
Long,Absentee by Mail,40,Commissioner Of Agriculture,40,0
Long,Advance in Person,691,Commissioner Of Agriculture,679,12
Long,Election Day,1397,Commissioner Of Agriculture,1368,29
Long,Provisional,6,Commissioner Of Agriculture,6,0
Lowndes,Absentee by Mail,532,Commissioner Of Agriculture,523,9
Lowndes,Advance in Person,8813,Commissioner Of Agriculture,8768,45
Lowndes,Election Day,11478,Commissioner Of Agriculture,11427,51
Lowndes,Provisional,560,Commissioner Of Agriculture,557,3
Lumpkin,Absentee by Mail,305,Commissioner Of Agriculture,296,9
Lumpkin,Advance in Person,2933,Commissioner Of Agriculture,2890,43
Lumpkin,Election Day,4404,Commissioner Of Agriculture,4358,46
Lumpkin,Provisional,15,Commissioner Of Agriculture,15,0
Macon,Absentee by Mail,106,Commissioner Of Agriculture,106,0
Macon,Advance in Person,1207,Commissioner Of Agriculture,1146,61
Macon,Election Day,1695,Commissioner Of Agriculture,1642,53
Macon,Provisional,0,Commissioner Of Agriculture,0,0
Madison,Absentee by Mail,312,Commissioner Of Agriculture,305,7
Madison,Advance in Person,2257,Commissioner Of Agriculture,2248,9
Madison,Election Day,4970,Commissioner Of Agriculture,4915,55
Madison,Provisional,6,Commissioner Of Agriculture,6,0
Marion,Absentee by Mail,219,Commissioner Of Agriculture,216,3
Marion,Advance in Person,612,Commissioner Of Agriculture,599,13
Marion,Election Day,1314,Commissioner Of Agriculture,1298,16
Marion,Provisional,0,Commissioner Of Agriculture,0,0
McDuffie,Absentee by Mail,351,Commissioner Of Agriculture,344,7
McDuffie,Advance in Person,2043,Commissioner Of Agriculture,2016,27
McDuffie,Election Day,3653,Commissioner Of Agriculture,3632,21
McDuffie,Provisional,3,Commissioner Of Agriculture,3,0
McIntosh,Absentee by Mail,300,Commissioner Of Agriculture,292,8
McIntosh,Advance in Person,1300,Commissioner Of Agriculture,1277,23
McIntosh,Election Day,2233,Commissioner Of Agriculture,2203,30
McIntosh,Provisional,7,Commissioner Of Agriculture,6,1
Meriwether,Absentee by Mail,207,Commissioner Of Agriculture,202,5
Meriwether,Advance in Person,1188,Commissioner Of Agriculture,1169,19
Meriwether,Election Day,4671,Commissioner Of Agriculture,4603,68
Meriwether,Provisional,1,Commissioner Of Agriculture,1,0
Miller,Absentee by Mail,53,Commissioner Of Agriculture,52,1
Miller,Advance in Person,436,Commissioner Of Agriculture,432,4
Miller,Election Day,937,Commissioner Of Agriculture,936,1
Miller,Provisional,1,Commissioner Of Agriculture,1,0
Mitchell,Absentee by Mail,202,Commissioner Of Agriculture,199,3
Mitchell,Advance in Person,1589,Commissioner Of Agriculture,1568,21
Mitchell,Election Day,3215,Commissioner Of Agriculture,3182,33
Mitchell,Provisional,3,Commissioner Of Agriculture,3,0
Monroe,Absentee by Mail,358,Commissioner Of Agriculture,353,5
Monroe,Advance in Person,2523,Commissioner Of Agriculture,2481,42
Monroe,Election Day,5671,Commissioner Of Agriculture,5614,57
Monroe,Provisional,23,Commissioner Of Agriculture,22,1
Montgomery,Absentee by Mail,92,Commissioner Of Agriculture,89,3
Montgomery,Advance in Person,463,Commissioner Of Agriculture,446,17
Montgomery,Election Day,1730,Commissioner Of Agriculture,1716,14
Montgomery,Provisional,0,Commissioner Of Agriculture,0,0
Morgan,Absentee by Mail,193,Commissioner Of Agriculture,188,5
Morgan,Advance in Person,2475,Commissioner Of Agriculture,2448,27
Morgan,Election Day,3635,Commissioner Of Agriculture,3599,36
Morgan,Provisional,7,Commissioner Of Agriculture,7,0
Murray,Absentee by Mail,207,Commissioner Of Agriculture,196,11
Murray,Advance in Person,1347,Commissioner Of Agriculture,1314,33
Murray,Election Day,4497,Commissioner Of Agriculture,4413,84
Murray,Provisional,0,Commissioner Of Agriculture,0,0
Muscogee,Absentee by Mail,2150,Commissioner Of Agriculture,2115,35
Muscogee,Advance in Person,13494,Commissioner Of Agriculture,13206,288
Muscogee,Election Day,25301,Commissioner Of Agriculture,25011,290
Muscogee,Provisional,63,Commissioner Of Agriculture,63,0
Newton,Absentee by Mail,1136,Commissioner Of Agriculture,1112,24
Newton,Advance in Person,10430,Commissioner Of Agriculture,10337,93
Newton,Election Day,16634,Commissioner Of Agriculture,16516,118
Newton,Provisional,2,Commissioner Of Agriculture,2,0
Oconee,Absentee by Mail,368,Commissioner Of Agriculture,357,11
Oconee,Advance in Person,5438,Commissioner Of Agriculture,5372,66
Oconee,Election Day,7726,Commissioner Of Agriculture,7560,166
Oconee,Provisional,7,Commissioner Of Agriculture,7,0
Oglethorpe,Absentee by Mail,217,Commissioner Of Agriculture,213,4
Oglethorpe,Advance in Person,1609,Commissioner Of Agriculture,1593,16
Oglethorpe,Election Day,2262,Commissioner Of Agriculture,2246,16
Oglethorpe,Provisional,4,Commissioner Of Agriculture,4,0
Paulding,Absentee by Mail,1789,Commissioner Of Agriculture,1763,26
Paulding,Advance in Person,14824,Commissioner Of Agriculture,14726,98
Paulding,Election Day,19620,Commissioner Of Agriculture,19512,108
Paulding,Provisional,29,Commissioner Of Agriculture,28,1
Peach,Absentee by Mail,215,Commissioner Of Agriculture,213,2
Peach,Advance in Person,3402,Commissioner Of Agriculture,3360,42
Peach,Election Day,3620,Commissioner Of Agriculture,3590,30
Peach,Provisional,8,Commissioner Of Agriculture,8,0
Pickens,Absentee by Mail,138,Commissioner Of Agriculture,136,2
Pickens,Advance in Person,3653,Commissioner Of Agriculture,3593,60
Pickens,Election Day,5031,Commissioner Of Agriculture,4982,49
Pickens,Provisional,1,Commissioner Of Agriculture,1,0
Pierce,Absentee by Mail,228,Commissioner Of Agriculture,225,3
Pierce,Advance in Person,1629,Commissioner Of Agriculture,1598,31
Pierce,Election Day,2106,Commissioner Of Agriculture,2087,19
Pierce,Provisional,0,Commissioner Of Agriculture,0,0
Pike,Absentee by Mail,246,Commissioner Of Agriculture,243,3
Pike,Advance in Person,1650,Commissioner Of Agriculture,1641,9
Pike,Election Day,3700,Commissioner Of Agriculture,3665,35
Pike,Provisional,8,Commissioner Of Agriculture,8,0
Polk,Absentee by Mail,235,Commissioner Of Agriculture,230,5
Polk,Advance in Person,3214,Commissioner Of Agriculture,3171,43
Polk,Election Day,4537,Commissioner Of Agriculture,4477,60
Polk,Provisional,4,Commissioner Of Agriculture,4,0
Pulaski,Absentee by Mail,86,Commissioner Of Agriculture,85,1
Pulaski,Advance in Person,1249,Commissioner Of Agriculture,1226,23
Pulaski,Election Day,1013,Commissioner Of Agriculture,990,23
Pulaski,Provisional,2,Commissioner Of Agriculture,2,0
Putnam,Absentee by Mail,387,Commissioner Of Agriculture,383,4
Putnam,Advance in Person,2434,Commissioner Of Agriculture,2406,28
Putnam,Election Day,3451,Commissioner Of Agriculture,3427,24
Putnam,Provisional,2,Commissioner Of Agriculture,2,0
Quitman,Absentee by Mail,41,Commissioner Of Agriculture,40,1
Quitman,Advance in Person,209,Commissioner Of Agriculture,202,7
Quitman,Election Day,347,Commissioner Of Agriculture,339,8
Quitman,Provisional,1,Commissioner Of Agriculture,1,0
Rabun,Absentee by Mail,427,Commissioner Of Agriculture,417,10
Rabun,Advance in Person,3295,Commissioner Of Agriculture,3225,70
Rabun,Election Day,1731,Commissioner Of Agriculture,1688,43
Rabun,Provisional,0,Commissioner Of Agriculture,0,0
Randolph,Absentee by Mail,149,Commissioner Of Agriculture,142,7
Randolph,Advance in Person,789,Commissioner Of Agriculture,774,15
Randolph,Election Day,1173,Commissioner Of Agriculture,1162,11
Randolph,Provisional,7,Commissioner Of Agriculture,7,0
Richmond,Absentee by Mail,3207,Commissioner Of Agriculture,3158,49
Richmond,Advance in Person,13314,Commissioner Of Agriculture,13119,195
Richmond,Election Day,31248,Commissioner Of Agriculture,30806,442
Richmond,Provisional,71,Commissioner Of Agriculture,71,0
Rockdale,Absentee by Mail,825,Commissioner Of Agriculture,812,13
Rockdale,Advance in Person,13442,Commissioner Of Agriculture,13324,118
Rockdale,Election Day,12256,Commissioner Of Agriculture,12147,109
Rockdale,Provisional,48,Commissioner Of Agriculture,48,0
Schley,Absentee by Mail,66,Commissioner Of Agriculture,63,3
Schley,Advance in Person,602,Commissioner Of Agriculture,591,11
Schley,Election Day,595,Commissioner Of Agriculture,580,15
Schley,Provisional,3,Commissioner Of Agriculture,3,0
Screven,Absentee by Mail,158,Commissioner Of Agriculture,155,3
Screven,Advance in Person,1201,Commissioner Of Agriculture,1193,8
Screven,Election Day,2412,Commissioner Of Agriculture,2403,9
Screven,Provisional,4,Commissioner Of Agriculture,4,0
Seminole,Absentee by Mail,76,Commissioner Of Agriculture,74,2
Seminole,Advance in Person,477,Commissioner Of Agriculture,472,5
Seminole,Election Day,1698,Commissioner Of Agriculture,1671,27
Seminole,Provisional,5,Commissioner Of Agriculture,5,0
Spalding,Absentee by Mail,528,Commissioner Of Agriculture,505,23
Spalding,Advance in Person,6771,Commissioner Of Agriculture,6622,149
Spalding,Election Day,9378,Commissioner Of Agriculture,9262,116
Spalding,Provisional,14,Commissioner Of Agriculture,14,0
Stephens,Absentee by Mail,337,Commissioner Of Agriculture,332,5
Stephens,Advance in Person,2604,Commissioner Of Agriculture,2604,0
Stephens,Election Day,2225,Commissioner Of Agriculture,2225,0
Stephens,Provisional,2,Commissioner Of Agriculture,2,0
Stewart,Absentee by Mail,75,Commissioner Of Agriculture,74,1
Stewart,Advance in Person,311,Commissioner Of Agriculture,287,24
Stewart,Election Day,808,Commissioner Of Agriculture,774,34
Stewart,Provisional,18,Commissioner Of Agriculture,18,0
Sumter,Absentee by Mail,522,Commissioner Of Agriculture,518,4
Sumter,Advance in Person,3280,Commissioner Of Agriculture,3236,44
Sumter,Election Day,4191,Commissioner Of Agriculture,4109,82
Sumter,Provisional,5,Commissioner Of Agriculture,5,0
Talbot,Absentee by Mail,215,Commissioner Of Agriculture,206,9
Talbot,Advance in Person,342,Commissioner Of Agriculture,335,7
Talbot,Election Day,1588,Commissioner Of Agriculture,1548,40
Talbot,Provisional,2,Commissioner Of Agriculture,1,1
Taliaferro,Absentee by Mail,50,Commissioner Of Agriculture,48,2
Taliaferro,Advance in Person,197,Commissioner Of Agriculture,190,7
Taliaferro,Election Day,311,Commissioner Of Agriculture,311,0
Taliaferro,Provisional,0,Commissioner Of Agriculture,0,0
Tattnall,Absentee by Mail,198,Commissioner Of Agriculture,192,6
Tattnall,Advance in Person,1310,Commissioner Of Agriculture,1292,18
Tattnall,Election Day,2706,Commissioner Of Agriculture,2679,27
Tattnall,Provisional,6,Commissioner Of Agriculture,6,0
Taylor,Absentee by Mail,127,Commissioner Of Agriculture,127,0
Taylor,Advance in Person,620,Commissioner Of Agriculture,609,11
Taylor,Election Day,1441,Commissioner Of Agriculture,1423,18
Taylor,Provisional,0,Commissioner Of Agriculture,0,0
Telfair,Absentee by Mail,227,Commissioner Of Agriculture,224,3
Telfair,Advance in Person,751,Commissioner Of Agriculture,733,18
Telfair,Election Day,1723,Commissioner Of Agriculture,1697,26
Telfair,Provisional,0,Commissioner Of Agriculture,0,0
Terrell,Absentee by Mail,258,Commissioner Of Agriculture,239,19
Terrell,Advance in Person,1101,Commissioner Of Agriculture,1071,30
Terrell,Election Day,1887,Commissioner Of Agriculture,1862,25
Terrell,Provisional,2,Commissioner Of Agriculture,2,0
Thomas,Absentee by Mail,293,Commissioner Of Agriculture,287,6
Thomas,Advance in Person,3653,Commissioner Of Agriculture,3634,19
Thomas,Election Day,7055,Commissioner Of Agriculture,7008,47
Thomas,Provisional,2,Commissioner Of Agriculture,2,0
Tift,Absentee by Mail,254,Commissioner Of Agriculture,251,3
Tift,Advance in Person,3128,Commissioner Of Agriculture,3106,22
Tift,Election Day,5030,Commissioner Of Agriculture,4969,61
Tift,Provisional,92,Commissioner Of Agriculture,86,6
Toombs,Absentee by Mail,381,Commissioner Of Agriculture,375,6
Toombs,Advance in Person,1805,Commissioner Of Agriculture,1774,31
Toombs,Election Day,3352,Commissioner Of Agriculture,3345,7
Toombs,Provisional,6,Commissioner Of Agriculture,6,0
Towns,Absentee by Mail,190,Commissioner Of Agriculture,188,2
Towns,Advance in Person,2289,Commissioner Of Agriculture,2237,52
Towns,Election Day,1717,Commissioner Of Agriculture,1694,23
Towns,Provisional,68,Commissioner Of Agriculture,65,3
Treutlen,Absentee by Mail,50,Commissioner Of Agriculture,48,2
Treutlen,Advance in Person,426,Commissioner Of Agriculture,416,10
Treutlen,Election Day,1041,Commissioner Of Agriculture,1031,10
Treutlen,Provisional,3,Commissioner Of Agriculture,3,0
Troup,Absentee by Mail,847,Commissioner Of Agriculture,829,18
Troup,Advance in Person,4821,Commissioner Of Agriculture,4768,53
Troup,Election Day,9963,Commissioner Of Agriculture,9894,69
Troup,Provisional,41,Commissioner Of Agriculture,39,2
Turner,Absentee by Mail,41,Commissioner Of Agriculture,40,1
Turner,Advance in Person,1026,Commissioner Of Agriculture,1015,11
Turner,Election Day,1188,Commissioner Of Agriculture,1168,20
Turner,Provisional,11,Commissioner Of Agriculture,11,0
Twiggs,Absentee by Mail,275,Commissioner Of Agriculture,273,2
Twiggs,Advance in Person,841,Commissioner Of Agriculture,820,21
Twiggs,Election Day,1776,Commissioner Of Agriculture,1747,29
Twiggs,Provisional,1,Commissioner Of Agriculture,1,0
Union,Absentee by Mail,288,Commissioner Of Agriculture,279,9
Union,Advance in Person,3487,Commissioner Of Agriculture,3426,61
Union,Election Day,3966,Commissioner Of Agriculture,3908,58
Union,Provisional,2,Commissioner Of Agriculture,2,0
Upson,Absentee by Mail,230,Commissioner Of Agriculture,224,6
Upson,Advance in Person,2400,Commissioner Of Agriculture,2354,46
Upson,Election Day,4440,Commissioner Of Agriculture,4410,30
Upson,Provisional,1,Commissioner Of Agriculture,1,0
Walker,Absentee by Mail,617,Commissioner Of Agriculture,598,19
Walker,Advance in Person,3646,Commissioner Of Agriculture,3621,25
Walker,Election Day,8076,Commissioner Of Agriculture,8007,69
Walker,Provisional,0,Commissioner Of Agriculture,0,0
Walton,Absentee by Mail,1068,Commissioner Of Agriculture,1042,26
Walton,Advance in Person,6096,Commissioner Of Agriculture,6022,74
Walton,Election Day,18659,Commissioner Of Agriculture,18500,159
Walton,Provisional,16,Commissioner Of Agriculture,16,0
Ware,Absentee by Mail,326,Commissioner Of Agriculture,322,4
Ware,Advance in Person,2081,Commissioner Of Agriculture,2055,26
Ware,Election Day,4306,Commissioner Of Agriculture,4257,49
Ware,Provisional,1,Commissioner Of Agriculture,1,0
Warren,Absentee by Mail,60,Commissioner Of Agriculture,57,3
Warren,Advance in Person,543,Commissioner Of Agriculture,521,22
Warren,Election Day,889,Commissioner Of Agriculture,877,12
Warren,Provisional,1,Commissioner Of Agriculture,1,0
Washington,Absentee by Mail,355,Commissioner Of Agriculture,345,10
Washington,Advance in Person,2324,Commissioner Of Agriculture,2258,66
Washington,Election Day,3362,Commissioner Of Agriculture,3286,76
Washington,Provisional,8,Commissioner Of Agriculture,8,0
Wayne,Absentee by Mail,258,Commissioner Of Agriculture,251,7
Wayne,Advance in Person,2152,Commissioner Of Agriculture,2147,5
Wayne,Election Day,3740,Commissioner Of Agriculture,3712,28
Wayne,Provisional,0,Commissioner Of Agriculture,0,0
Webster,Absentee by Mail,80,Commissioner Of Agriculture,78,2
Webster,Advance in Person,271,Commissioner Of Agriculture,267,4
Webster,Election Day,426,Commissioner Of Agriculture,421,5
Webster,Provisional,0,Commissioner Of Agriculture,0,0
Wheeler,Absentee by Mail,87,Commissioner Of Agriculture,86,1
Wheeler,Advance in Person,447,Commissioner Of Agriculture,436,11
Wheeler,Election Day,959,Commissioner Of Agriculture,955,4
Wheeler,Provisional,9,Commissioner Of Agriculture,8,1
White,Absentee by Mail,447,Commissioner Of Agriculture,434,13
White,Advance in Person,2267,Commissioner Of Agriculture,2245,22
White,Election Day,4948,Commissioner Of Agriculture,4906,42
White,Provisional,3,Commissioner Of Agriculture,3,0
Whitfield,Absentee by Mail,478,Commissioner Of Agriculture,468,10
Whitfield,Advance in Person,3511,Commissioner Of Agriculture,3443,68
Whitfield,Election Day,11767,Commissioner Of Agriculture,11582,185
Whitfield,Provisional,38,Commissioner Of Agriculture,38,0
Wilcox,Absentee by Mail,144,Commissioner Of Agriculture,142,2
Wilcox,Advance in Person,455,Commissioner Of Agriculture,449,6
Wilcox,Election Day,1280,Commissioner Of Agriculture,1274,6
Wilcox,Provisional,3,Commissioner Of Agriculture,3,0
Wilkes,Absentee by Mail,104,Commissioner Of Agriculture,101,3
Wilkes,Advance in Person,939,Commissioner Of Agriculture,930,9
Wilkes,Election Day,2044,Commissioner Of Agriculture,2010,34
Wilkes,Provisional,3,Commissioner Of Agriculture,3,0
Wilkinson,Absentee by Mail,150,Commissioner Of Agriculture,149,1
Wilkinson,Advance in Person,763,Commissioner Of Agriculture,734,29
Wilkinson,Election Day,2227,Commissioner Of Agriculture,2177,50
Wilkinson,Provisional,1,Commissioner Of Agriculture,1,0
Worth,Absentee by Mail,138,Commissioner Of Agriculture,136,2
Worth,Advance in Person,1170,Commissioner Of Agriculture,1153,17
Worth,Election Day,3871,Commissioner Of Agriculture,3841,30
Worth,Provisional,10,Commissioner Of Agriculture,10,0
Appling,Absentee by Mail,306,Commissioner Of Insurance,302,4
Appling,Advance in Person,976,Commissioner Of Insurance,967,9
Appling,Election Day,3122,Commissioner Of Insurance,3068,54
Appling,Provisional,4,Commissioner Of Insurance,4,0
Atkinson,Absentee by Mail,68,Commissioner Of Insurance,66,2
Atkinson,Advance in Person,495,Commissioner Of Insurance,476,19
Atkinson,Election Day,1058,Commissioner Of Insurance,1008,50
Atkinson,Provisional,7,Commissioner Of Insurance,7,0
Bacon,Absentee by Mail,73,Commissioner Of Insurance,71,2
Bacon,Advance in Person,887,Commissioner Of Insurance,871,16
Bacon,Election Day,1240,Commissioner Of Insurance,1232,8
Bacon,Provisional,3,Commissioner Of Insurance,3,0
Baker,Absentee by Mail,71,Commissioner Of Insurance,67,4
Baker,Advance in Person,298,Commissioner Of Insurance,294,4
Baker,Election Day,617,Commissioner Of Insurance,606,11
Baker,Provisional,3,Commissioner Of Insurance,3,0
Baldwin,Absentee by Mail,409,Commissioner Of Insurance,404,5
Baldwin,Advance in Person,3933,Commissioner Of Insurance,3864,69
Baldwin,Election Day,6152,Commissioner Of Insurance,6110,42
Baldwin,Provisional,9,Commissioner Of Insurance,9,0
Banks,Absentee by Mail,142,Commissioner Of Insurance,137,5
Banks,Advance in Person,852,Commissioner Of Insurance,841,11
Banks,Election Day,3339,Commissioner Of Insurance,3303,36
Banks,Provisional,1,Commissioner Of Insurance,1,0
Barrow,Absentee by Mail,701,Commissioner Of Insurance,694,7
Barrow,Advance in Person,4720,Commissioner Of Insurance,4715,5
Barrow,Election Day,10688,Commissioner Of Insurance,10615,73
Barrow,Provisional,8,Commissioner Of Insurance,7,1
Bartow,Absentee by Mail,772,Commissioner Of Insurance,761,11
Bartow,Advance in Person,5826,Commissioner Of Insurance,5810,16
Bartow,Election Day,16152,Commissioner Of Insurance,15988,164
Bartow,Provisional,20,Commissioner Of Insurance,20,0
Ben Hill,Absentee by Mail,136,Commissioner Of Insurance,130,6
Ben Hill,Advance in Person,1494,Commissioner Of Insurance,1474,20
Ben Hill,Election Day,1864,Commissioner Of Insurance,1849,15
Ben Hill,Provisional,3,Commissioner Of Insurance,3,0
Berrien,Absentee by Mail,212,Commissioner Of Insurance,209,3
Berrien,Advance in Person,1103,Commissioner Of Insurance,1094,9
Berrien,Election Day,2608,Commissioner Of Insurance,2593,15
Berrien,Provisional,8,Commissioner Of Insurance,8,0
Bibb,Absentee by Mail,2189,Commissioner Of Insurance,2142,47
Bibb,Advance in Person,10315,Commissioner Of Insurance,10204,111
Bibb,Election Day,29989,Commissioner Of Insurance,29592,397
Bibb,Provisional,78,Commissioner Of Insurance,78,0
Bleckley,Absentee by Mail,228,Commissioner Of Insurance,219,9
Bleckley,Advance in Person,1157,Commissioner Of Insurance,1135,22
Bleckley,Election Day,1855,Commissioner Of Insurance,1841,14
Bleckley,Provisional,5,Commissioner Of Insurance,4,1
Brantley,Absentee by Mail,143,Commissioner Of Insurance,141,2
Brantley,Advance in Person,747,Commissioner Of Insurance,735,12
Brantley,Election Day,2086,Commissioner Of Insurance,2050,36
Brantley,Provisional,4,Commissioner Of Insurance,3,1
Brooks,Absentee by Mail,1016,Commissioner Of Insurance,997,19
Brooks,Advance in Person,1259,Commissioner Of Insurance,1237,22
Brooks,Election Day,2355,Commissioner Of Insurance,2338,17
Brooks,Provisional,26,Commissioner Of Insurance,24,2
Bryan,Absentee by Mail,237,Commissioner Of Insurance,230,7
Bryan,Advance in Person,2852,Commissioner Of Insurance,2835,17
Bryan,Election Day,4863,Commissioner Of Insurance,4840,23
Bryan,Provisional,3,Commissioner Of Insurance,3,0
Bulloch,Absentee by Mail,541,Commissioner Of Insurance,534,7
Bulloch,Advance in Person,3846,Commissioner Of Insurance,3839,7
Bulloch,Election Day,9455,Commissioner Of Insurance,9403,52
Bulloch,Provisional,12,Commissioner Of Insurance,10,2
Burke,Absentee by Mail,594,Commissioner Of Insurance,590,4
Burke,Advance in Person,1260,Commissioner Of Insurance,1250,10
Burke,Election Day,4049,Commissioner Of Insurance,3995,54
Burke,Provisional,0,Commissioner Of Insurance,0,0
Butts,Absentee by Mail,183,Commissioner Of Insurance,181,2
Butts,Advance in Person,3252,Commissioner Of Insurance,3235,17
Butts,Election Day,2671,Commissioner Of Insurance,2653,18
Butts,Provisional,0,Commissioner Of Insurance,0,0
Calhoun,Absentee by Mail,91,Commissioner Of Insurance,91,0
Calhoun,Advance in Person,320,Commissioner Of Insurance,315,5
Calhoun,Election Day,1044,Commissioner Of Insurance,1041,3
Calhoun,Provisional,2,Commissioner Of Insurance,2,0
Camden,Absentee by Mail,586,Commissioner Of Insurance,582,4
Camden,Advance in Person,2509,Commissioner Of Insurance,2482,27
Camden,Election Day,6720,Commissioner Of Insurance,6686,34
Camden,Provisional,9,Commissioner Of Insurance,9,0
Candler,Absentee by Mail,108,Commissioner Of Insurance,106,2
Candler,Advance in Person,835,Commissioner Of Insurance,831,4
Candler,Election Day,1258,Commissioner Of Insurance,1246,12
Candler,Provisional,0,Commissioner Of Insurance,0,0
Carroll,Absentee by Mail,845,Commissioner Of Insurance,833,12
Carroll,Advance in Person,7673,Commissioner Of Insurance,7627,46
Carroll,Election Day,17495,Commissioner Of Insurance,17389,106
Carroll,Provisional,53,Commissioner Of Insurance,51,2
Catoosa,Absentee by Mail,456,Commissioner Of Insurance,440,16
Catoosa,Advance in Person,4909,Commissioner Of Insurance,4835,74
Catoosa,Election Day,8541,Commissioner Of Insurance,8401,140
Catoosa,Provisional,14,Commissioner Of Insurance,14,0
Charlton,Absentee by Mail,80,Commissioner Of Insurance,80,0
Charlton,Advance in Person,684,Commissioner Of Insurance,679,5
Charlton,Election Day,1247,Commissioner Of Insurance,1236,11
Charlton,Provisional,4,Commissioner Of Insurance,4,0
Chatham,Absentee by Mail,2948,Commissioner Of Insurance,2881,67
Chatham,Advance in Person,17241,Commissioner Of Insurance,17179,62
Chatham,Election Day,48480,Commissioner Of Insurance,48168,312
Chatham,Provisional,55,Commissioner Of Insurance,53,2
Chattahoochee,Absentee by Mail,22,Commissioner Of Insurance,22,0
Chattahoochee,Advance in Person,196,Commissioner Of Insurance,194,2
Chattahoochee,Election Day,481,Commissioner Of Insurance,477,4
Chattahoochee,Provisional,2,Commissioner Of Insurance,2,0
Chattooga,Absentee by Mail,107,Commissioner Of Insurance,107,0
Chattooga,Advance in Person,1625,Commissioner Of Insurance,1589,36
Chattooga,Election Day,3090,Commissioner Of Insurance,3038,52
Chattooga,Provisional,2,Commissioner Of Insurance,2,0
Cherokee,Absentee by Mail,2440,Commissioner Of Insurance,2365,75
Cherokee,Advance in Person,23437,Commissioner Of Insurance,23158,279
Cherokee,Election Day,40811,Commissioner Of Insurance,40137,674
Cherokee,Provisional,31,Commissioner Of Insurance,29,2
Clarke,Absentee by Mail,1152,Commissioner Of Insurance,1117,35
Clarke,Advance in Person,7332,Commissioner Of Insurance,7225,107
Clarke,Election Day,16976,Commissioner Of Insurance,16585,391
Clarke,Provisional,76,Commissioner Of Insurance,72,4
Clay,Absentee by Mail,90,Commissioner Of Insurance,88,2
Clay,Advance in Person,244,Commissioner Of Insurance,240,4
Clay,Election Day,602,Commissioner Of Insurance,595,7
Clay,Provisional,1,Commissioner Of Insurance,1,0
Clayton,Absentee by Mail,1772,Commissioner Of Insurance,1749,23
Clayton,Advance in Person,25878,Commissioner Of Insurance,25789,89
Clayton,Election Day,34794,Commissioner Of Insurance,34670,124
Clayton,Provisional,66,Commissioner Of Insurance,63,3
Clinch,Absentee by Mail,53,Commissioner Of Insurance,52,1
Clinch,Advance in Person,340,Commissioner Of Insurance,336,4
Clinch,Election Day,777,Commissioner Of Insurance,769,8
Clinch,Provisional,2,Commissioner Of Insurance,2,0
Cobb,Absentee by Mail,10616,Commissioner Of Insurance,10315,301
Cobb,Advance in Person,58755,Commissioner Of Insurance,58044,711
Cobb,Election Day,143123,Commissioner Of Insurance,140342,2781
Cobb,Provisional,581,Commissioner Of Insurance,561,20
Coffee,Absentee by Mail,328,Commissioner Of Insurance,327,1
Coffee,Advance in Person,3477,Commissioner Of Insurance,3449,28
Coffee,Election Day,4390,Commissioner Of Insurance,4312,78
Coffee,Provisional,7,Commissioner Of Insurance,7,0
Colquitt,Absentee by Mail,172,Commissioner Of Insurance,169,3
Colquitt,Advance in Person,2409,Commissioner Of Insurance,2395,14
Colquitt,Election Day,5359,Commissioner Of Insurance,5320,39
Colquitt,Provisional,4,Commissioner Of Insurance,4,0
Columbia,Absentee by Mail,1698,Commissioner Of Insurance,1670,28
Columbia,Advance in Person,11710,Commissioner Of Insurance,11678,32
Columbia,Election Day,26403,Commissioner Of Insurance,26305,98
Columbia,Provisional,10,Commissioner Of Insurance,10,0
Cook,Absentee by Mail,113,Commissioner Of Insurance,113,0
Cook,Advance in Person,1115,Commissioner Of Insurance,1112,3
Cook,Election Day,2316,Commissioner Of Insurance,2296,20
Cook,Provisional,0,Commissioner Of Insurance,0,0
Coweta,Absentee by Mail,1733,Commissioner Of Insurance,1705,28
Coweta,Advance in Person,9167,Commissioner Of Insurance,9120,47
Coweta,Election Day,26256,Commissioner Of Insurance,26028,228
Coweta,Provisional,15,Commissioner Of Insurance,15,0
Crawford,Absentee by Mail,146,Commissioner Of Insurance,144,2
Crawford,Advance in Person,1092,Commissioner Of Insurance,1068,24
Crawford,Election Day,2012,Commissioner Of Insurance,1985,27
Crawford,Provisional,4,Commissioner Of Insurance,4,0
Crisp,Absentee by Mail,169,Commissioner Of Insurance,163,6
Crisp,Advance in Person,2060,Commissioner Of Insurance,2036,24
Crisp,Election Day,2752,Commissioner Of Insurance,2706,46
Crisp,Provisional,2,Commissioner Of Insurance,2,0
Dade,Absentee by Mail,114,Commissioner Of Insurance,107,7
Dade,Advance in Person,1030,Commissioner Of Insurance,993,37
Dade,Election Day,2283,Commissioner Of Insurance,2208,75
Dade,Provisional,9,Commissioner Of Insurance,9,0
Dawson,Absentee by Mail,311,Commissioner Of Insurance,303,8
Dawson,Advance in Person,3231,Commissioner Of Insurance,3187,44
Dawson,Election Day,3731,Commissioner Of Insurance,3663,68
Dawson,Provisional,11,Commissioner Of Insurance,10,1
DeKalb,Absentee by Mail,8280,Commissioner Of Insurance,7970,310
DeKalb,Advance in Person,72480,Commissioner Of Insurance,71607,873
DeKalb,Election Day,129376,Commissioner Of Insurance,126451,2925
DeKalb,Provisional,503,Commissioner Of Insurance,478,25
Decatur,Absentee by Mail,269,Commissioner Of Insurance,267,2
Decatur,Advance in Person,1985,Commissioner Of Insurance,1984,1
Decatur,Election Day,3820,Commissioner Of Insurance,3805,15
Decatur,Provisional,5,Commissioner Of Insurance,5,0
Dodge,Absentee by Mail,219,Commissioner Of Insurance,214,5
Dodge,Advance in Person,1690,Commissioner Of Insurance,1631,59
Dodge,Election Day,3173,Commissioner Of Insurance,3047,126
Dodge,Provisional,0,Commissioner Of Insurance,0,0
Dooly,Absentee by Mail,68,Commissioner Of Insurance,68,0
Dooly,Advance in Person,834,Commissioner Of Insurance,803,31
Dooly,Election Day,1783,Commissioner Of Insurance,1747,36
Dooly,Provisional,0,Commissioner Of Insurance,0,0
Dougherty,Absentee by Mail,1050,Commissioner Of Insurance,1036,14
Dougherty,Advance in Person,6272,Commissioner Of Insurance,6216,56
Dougherty,Election Day,16148,Commissioner Of Insurance,16073,75
Dougherty,Provisional,41,Commissioner Of Insurance,39,2
Douglas,Absentee by Mail,1308,Commissioner Of Insurance,1285,23
Douglas,Advance in Person,15797,Commissioner Of Insurance,15743,54
Douglas,Election Day,20398,Commissioner Of Insurance,20354,44
Douglas,Provisional,27,Commissioner Of Insurance,27,0
Early,Absentee by Mail,140,Commissioner Of Insurance,138,2
Early,Advance in Person,890,Commissioner Of Insurance,873,17
Early,Election Day,2163,Commissioner Of Insurance,2153,10
Early,Provisional,3,Commissioner Of Insurance,3,0
Echols,Absentee by Mail,19,Commissioner Of Insurance,19,0
Echols,Advance in Person,243,Commissioner Of Insurance,238,5
Echols,Election Day,361,Commissioner Of Insurance,351,10
Echols,Provisional,0,Commissioner Of Insurance,0,0
Effingham,Absentee by Mail,373,Commissioner Of Insurance,367,6
Effingham,Advance in Person,3036,Commissioner Of Insurance,3031,5
Effingham,Election Day,9204,Commissioner Of Insurance,9150,54
Effingham,Provisional,10,Commissioner Of Insurance,10,0
Elbert,Absentee by Mail,219,Commissioner Of Insurance,217,2
Elbert,Advance in Person,1841,Commissioner Of Insurance,1833,8
Elbert,Election Day,2632,Commissioner Of Insurance,2627,5
Elbert,Provisional,11,Commissioner Of Insurance,11,0
Emanuel,Absentee by Mail,213,Commissioner Of Insurance,208,5
Emanuel,Advance in Person,1187,Commissioner Of Insurance,1150,37
Emanuel,Election Day,3581,Commissioner Of Insurance,3510,71
Emanuel,Provisional,1,Commissioner Of Insurance,1,0
Evans,Absentee by Mail,122,Commissioner Of Insurance,119,3
Evans,Advance in Person,921,Commissioner Of Insurance,906,15
Evans,Election Day,1107,Commissioner Of Insurance,1091,16
Evans,Provisional,0,Commissioner Of Insurance,0,0
Fannin,Absentee by Mail,417,Commissioner Of Insurance,408,9
Fannin,Advance in Person,2268,Commissioner Of Insurance,2221,47
Fannin,Election Day,4216,Commissioner Of Insurance,4137,79
Fannin,Provisional,3,Commissioner Of Insurance,2,1
Fayette,Absentee by Mail,1272,Commissioner Of Insurance,1236,36
Fayette,Advance in Person,18189,Commissioner Of Insurance,18003,186
Fayette,Election Day,22606,Commissioner Of Insurance,22270,336
Fayette,Provisional,13,Commissioner Of Insurance,13,0
Floyd,Absentee by Mail,771,Commissioner Of Insurance,753,18
Floyd,Advance in Person,5763,Commissioner Of Insurance,5722,41
Floyd,Election Day,14210,Commissioner Of Insurance,14020,190
Floyd,Provisional,78,Commissioner Of Insurance,75,3
Forsyth,Absentee by Mail,1655,Commissioner Of Insurance,1612,43
Forsyth,Advance in Person,22647,Commissioner Of Insurance,22385,262
Forsyth,Election Day,32220,Commissioner Of Insurance,31814,406
Forsyth,Provisional,48,Commissioner Of Insurance,46,2
Franklin,Absentee by Mail,198,Commissioner Of Insurance,198,0
Franklin,Advance in Person,1077,Commissioner Of Insurance,1074,3
Franklin,Election Day,3454,Commissioner Of Insurance,3447,7
Franklin,Provisional,1,Commissioner Of Insurance,1,0
Fulton,Absentee by Mail,8864,Commissioner Of Insurance,8523,341
Fulton,Advance in Person,87201,Commissioner Of Insurance,85889,1312
Fulton,Election Day,167468,Commissioner Of Insurance,163497,3971
Fulton,Provisional,2135,Commissioner Of Insurance,2035,100
Gilmer,Absentee by Mail,378,Commissioner Of Insurance,373,5
Gilmer,Advance in Person,2578,Commissioner Of Insurance,2537,41
Gilmer,Election Day,4854,Commissioner Of Insurance,4723,131
Gilmer,Provisional,16,Commissioner Of Insurance,16,0
Glascock,Absentee by Mail,36,Commissioner Of Insurance,34,2
Glascock,Advance in Person,211,Commissioner Of Insurance,201,10
Glascock,Election Day,542,Commissioner Of Insurance,538,4
Glascock,Provisional,0,Commissioner Of Insurance,0,0
Glynn,Absentee by Mail,883,Commissioner Of Insurance,873,10
Glynn,Advance in Person,7098,Commissioner Of Insurance,7055,43
Glynn,Election Day,12102,Commissioner Of Insurance,12023,79
Glynn,Provisional,36,Commissioner Of Insurance,35,1
Gordon,Absentee by Mail,370,Commissioner Of Insurance,358,12
Gordon,Advance in Person,2666,Commissioner Of Insurance,2603,63
Gordon,Election Day,7273,Commissioner Of Insurance,7112,161
Gordon,Provisional,16,Commissioner Of Insurance,15,1
Grady,Absentee by Mail,157,Commissioner Of Insurance,153,4
Grady,Advance in Person,1854,Commissioner Of Insurance,1837,17
Grady,Election Day,3548,Commissioner Of Insurance,3528,20
Grady,Provisional,6,Commissioner Of Insurance,6,0
Greene,Absentee by Mail,538,Commissioner Of Insurance,527,11
Greene,Advance in Person,3068,Commissioner Of Insurance,3057,11
Greene,Election Day,2907,Commissioner Of Insurance,2862,45
Greene,Provisional,10,Commissioner Of Insurance,10,0
Gwinnett,Absentee by Mail,8170,Commissioner Of Insurance,7986,184
Gwinnett,Advance in Person,47244,Commissioner Of Insurance,46934,310
Gwinnett,Election Day,141636,Commissioner Of Insurance,139997,1639
Gwinnett,Provisional,1155,Commissioner Of Insurance,1123,32
Habersham,Absentee by Mail,704,Commissioner Of Insurance,690,14
Habersham,Advance in Person,5381,Commissioner Of Insurance,5281,100
Habersham,Election Day,3529,Commissioner Of Insurance,3481,48
Habersham,Provisional,34,Commissioner Of Insurance,31,3
Hall,Absentee by Mail,2074,Commissioner Of Insurance,2029,45
Hall,Advance in Person,12299,Commissioner Of Insurance,12150,149
Hall,Election Day,29428,Commissioner Of Insurance,28986,442
Hall,Provisional,42,Commissioner Of Insurance,42,0
Hancock,Absentee by Mail,283,Commissioner Of Insurance,280,3
Hancock,Advance in Person,839,Commissioner Of Insurance,812,27
Hancock,Election Day,1257,Commissioner Of Insurance,1233,24
Hancock,Provisional,19,Commissioner Of Insurance,15,4
Haralson,Absentee by Mail,262,Commissioner Of Insurance,256,6
Haralson,Advance in Person,1563,Commissioner Of Insurance,1549,14
Haralson,Election Day,4986,Commissioner Of Insurance,4934,52
Haralson,Provisional,2,Commissioner Of Insurance,2,0
Harris,Absentee by Mail,493,Commissioner Of Insurance,485,8
Harris,Advance in Person,2950,Commissioner Of Insurance,2946,4
Harris,Election Day,6803,Commissioner Of Insurance,6754,49
Harris,Provisional,2,Commissioner Of Insurance,2,0
Hart,Absentee by Mail,287,Commissioner Of Insurance,282,5
Hart,Advance in Person,2309,Commissioner Of Insurance,2262,47
Hart,Election Day,4185,Commissioner Of Insurance,4158,27
Hart,Provisional,1,Commissioner Of Insurance,1,0
Heard,Absentee by Mail,157,Commissioner Of Insurance,152,5
Heard,Advance in Person,552,Commissioner Of Insurance,535,17
Heard,Election Day,1772,Commissioner Of Insurance,1752,20
Heard,Provisional,0,Commissioner Of Insurance,0,0
Henry,Absentee by Mail,2016,Commissioner Of Insurance,1991,25
Henry,Advance in Person,29231,Commissioner Of Insurance,29187,44
Henry,Election Day,31732,Commissioner Of Insurance,31600,132
Henry,Provisional,102,Commissioner Of Insurance,101,1
Houston,Absentee by Mail,1431,Commissioner Of Insurance,1401,30
Houston,Advance in Person,16400,Commissioner Of Insurance,16308,92
Houston,Election Day,19454,Commissioner Of Insurance,19294,160
Houston,Provisional,62,Commissioner Of Insurance,57,5
Irwin,Absentee by Mail,61,Commissioner Of Insurance,59,2
Irwin,Advance in Person,719,Commissioner Of Insurance,693,26
Irwin,Election Day,1581,Commissioner Of Insurance,1552,29
Irwin,Provisional,3,Commissioner Of Insurance,2,1
Jackson,Absentee by Mail,495,Commissioner Of Insurance,488,7
Jackson,Advance in Person,5419,Commissioner Of Insurance,5399,20
Jackson,Election Day,10060,Commissioner Of Insurance,9969,91
Jackson,Provisional,16,Commissioner Of Insurance,14,2
Jasper,Absentee by Mail,255,Commissioner Of Insurance,253,2
Jasper,Advance in Person,1280,Commissioner Of Insurance,1274,6
Jasper,Election Day,2305,Commissioner Of Insurance,2296,9
Jasper,Provisional,2,Commissioner Of Insurance,2,0
Jeff Davis,Absentee by Mail,153,Commissioner Of Insurance,147,6
Jeff Davis,Advance in Person,861,Commissioner Of Insurance,841,20
Jeff Davis,Election Day,1973,Commissioner Of Insurance,1927,46
Jeff Davis,Provisional,1,Commissioner Of Insurance,1,0
Jefferson,Absentee by Mail,216,Commissioner Of Insurance,213,3
Jefferson,Advance in Person,1158,Commissioner Of Insurance,1144,14
Jefferson,Election Day,3144,Commissioner Of Insurance,3098,46
Jefferson,Provisional,20,Commissioner Of Insurance,20,0
Jenkins,Absentee by Mail,163,Commissioner Of Insurance,161,2
Jenkins,Advance in Person,671,Commissioner Of Insurance,671,0
Jenkins,Election Day,1088,Commissioner Of Insurance,1079,9
Jenkins,Provisional,0,Commissioner Of Insurance,0,0
Johnson,Absentee by Mail,92,Commissioner Of Insurance,90,2
Johnson,Advance in Person,789,Commissioner Of Insurance,781,8
Johnson,Election Day,1415,Commissioner Of Insurance,1410,5
Johnson,Provisional,0,Commissioner Of Insurance,0,0
Jones,Absentee by Mail,511,Commissioner Of Insurance,504,7
Jones,Advance in Person,2913,Commissioner Of Insurance,2892,21
Jones,Election Day,4638,Commissioner Of Insurance,4602,36
Jones,Provisional,7,Commissioner Of Insurance,7,0
Lamar,Absentee by Mail,215,Commissioner Of Insurance,207,8
Lamar,Advance in Person,1700,Commissioner Of Insurance,1681,19
Lamar,Election Day,3046,Commissioner Of Insurance,3039,7
Lamar,Provisional,5,Commissioner Of Insurance,5,0
Lanier,Absentee by Mail,40,Commissioner Of Insurance,40,0
Lanier,Advance in Person,521,Commissioner Of Insurance,507,14
Lanier,Election Day,878,Commissioner Of Insurance,865,13
Lanier,Provisional,4,Commissioner Of Insurance,4,0
Laurens,Absentee by Mail,763,Commissioner Of Insurance,754,9
Laurens,Advance in Person,3953,Commissioner Of Insurance,3911,42
Laurens,Election Day,8153,Commissioner Of Insurance,8039,114
Laurens,Provisional,14,Commissioner Of Insurance,13,1
Lee,Absentee by Mail,241,Commissioner Of Insurance,238,3
Lee,Advance in Person,2107,Commissioner Of Insurance,2092,15
Lee,Election Day,6514,Commissioner Of Insurance,6489,25
Lee,Provisional,5,Commissioner Of Insurance,5,0
Liberty,Absentee by Mail,209,Commissioner Of Insurance,204,5
Liberty,Advance in Person,3652,Commissioner Of Insurance,3634,18
Liberty,Election Day,5097,Commissioner Of Insurance,5071,26
Liberty,Provisional,4,Commissioner Of Insurance,3,1
Lincoln,Absentee by Mail,222,Commissioner Of Insurance,219,3
Lincoln,Advance in Person,899,Commissioner Of Insurance,889,10
Lincoln,Election Day,1554,Commissioner Of Insurance,1531,23
Lincoln,Provisional,13,Commissioner Of Insurance,13,0
Long,Absentee by Mail,40,Commissioner Of Insurance,39,1
Long,Advance in Person,691,Commissioner Of Insurance,685,6
Long,Election Day,1397,Commissioner Of Insurance,1363,34
Long,Provisional,6,Commissioner Of Insurance,6,0
Lowndes,Absentee by Mail,532,Commissioner Of Insurance,522,10
Lowndes,Advance in Person,8813,Commissioner Of Insurance,8794,19
Lowndes,Election Day,11478,Commissioner Of Insurance,11414,64
Lowndes,Provisional,560,Commissioner Of Insurance,553,7
Lumpkin,Absentee by Mail,305,Commissioner Of Insurance,300,5
Lumpkin,Advance in Person,2933,Commissioner Of Insurance,2907,26
Lumpkin,Election Day,4404,Commissioner Of Insurance,4344,60
Lumpkin,Provisional,15,Commissioner Of Insurance,14,1
Macon,Absentee by Mail,106,Commissioner Of Insurance,105,1
Macon,Advance in Person,1207,Commissioner Of Insurance,1148,59
Macon,Election Day,1695,Commissioner Of Insurance,1639,56
Macon,Provisional,0,Commissioner Of Insurance,0,0
Madison,Absentee by Mail,312,Commissioner Of Insurance,307,5
Madison,Advance in Person,2257,Commissioner Of Insurance,2250,7
Madison,Election Day,4970,Commissioner Of Insurance,4929,41
Madison,Provisional,6,Commissioner Of Insurance,6,0
Marion,Absentee by Mail,219,Commissioner Of Insurance,216,3
Marion,Advance in Person,612,Commissioner Of Insurance,602,10
Marion,Election Day,1314,Commissioner Of Insurance,1286,28
Marion,Provisional,0,Commissioner Of Insurance,0,0
McDuffie,Absentee by Mail,351,Commissioner Of Insurance,347,4
McDuffie,Advance in Person,2043,Commissioner Of Insurance,2015,28
McDuffie,Election Day,3653,Commissioner Of Insurance,3624,29
McDuffie,Provisional,3,Commissioner Of Insurance,3,0
McIntosh,Absentee by Mail,300,Commissioner Of Insurance,291,9
McIntosh,Advance in Person,1300,Commissioner Of Insurance,1287,13
McIntosh,Election Day,2233,Commissioner Of Insurance,2198,35
McIntosh,Provisional,7,Commissioner Of Insurance,6,1
Meriwether,Absentee by Mail,207,Commissioner Of Insurance,203,4
Meriwether,Advance in Person,1188,Commissioner Of Insurance,1176,12
Meriwether,Election Day,4671,Commissioner Of Insurance,4592,79
Meriwether,Provisional,1,Commissioner Of Insurance,1,0
Miller,Absentee by Mail,53,Commissioner Of Insurance,51,2
Miller,Advance in Person,436,Commissioner Of Insurance,427,9
Miller,Election Day,937,Commissioner Of Insurance,926,11
Miller,Provisional,1,Commissioner Of Insurance,1,0
Mitchell,Absentee by Mail,202,Commissioner Of Insurance,199,3
Mitchell,Advance in Person,1589,Commissioner Of Insurance,1563,26
Mitchell,Election Day,3215,Commissioner Of Insurance,3189,26
Mitchell,Provisional,3,Commissioner Of Insurance,3,0
Monroe,Absentee by Mail,358,Commissioner Of Insurance,350,8
Monroe,Advance in Person,2523,Commissioner Of Insurance,2483,40
Monroe,Election Day,5671,Commissioner Of Insurance,5623,48
Monroe,Provisional,23,Commissioner Of Insurance,22,1
Montgomery,Absentee by Mail,92,Commissioner Of Insurance,88,4
Montgomery,Advance in Person,463,Commissioner Of Insurance,451,12
Montgomery,Election Day,1730,Commissioner Of Insurance,1702,28
Montgomery,Provisional,0,Commissioner Of Insurance,0,0
Morgan,Absentee by Mail,193,Commissioner Of Insurance,190,3
Morgan,Advance in Person,2475,Commissioner Of Insurance,2451,24
Morgan,Election Day,3635,Commissioner Of Insurance,3604,31
Morgan,Provisional,7,Commissioner Of Insurance,6,1
Murray,Absentee by Mail,207,Commissioner Of Insurance,190,17
Murray,Advance in Person,1347,Commissioner Of Insurance,1312,35
Murray,Election Day,4497,Commissioner Of Insurance,4388,109
Murray,Provisional,0,Commissioner Of Insurance,0,0
Muscogee,Absentee by Mail,2150,Commissioner Of Insurance,2114,36
Muscogee,Advance in Person,13494,Commissioner Of Insurance,13371,123
Muscogee,Election Day,25301,Commissioner Of Insurance,25162,139
Muscogee,Provisional,63,Commissioner Of Insurance,63,0
Newton,Absentee by Mail,1136,Commissioner Of Insurance,1113,23
Newton,Advance in Person,10430,Commissioner Of Insurance,10402,28
Newton,Election Day,16634,Commissioner Of Insurance,16567,67
Newton,Provisional,2,Commissioner Of Insurance,2,0
Oconee,Absentee by Mail,368,Commissioner Of Insurance,359,9
Oconee,Advance in Person,5438,Commissioner Of Insurance,5377,61
Oconee,Election Day,7726,Commissioner Of Insurance,7557,169
Oconee,Provisional,7,Commissioner Of Insurance,7,0
Oglethorpe,Absentee by Mail,217,Commissioner Of Insurance,216,1
Oglethorpe,Advance in Person,1609,Commissioner Of Insurance,1599,10
Oglethorpe,Election Day,2262,Commissioner Of Insurance,2246,16
Oglethorpe,Provisional,4,Commissioner Of Insurance,4,0
Paulding,Absentee by Mail,1789,Commissioner Of Insurance,1759,30
Paulding,Advance in Person,14824,Commissioner Of Insurance,14801,23
Paulding,Election Day,19620,Commissioner Of Insurance,19572,48
Paulding,Provisional,29,Commissioner Of Insurance,29,0
Peach,Absentee by Mail,215,Commissioner Of Insurance,211,4
Peach,Advance in Person,3402,Commissioner Of Insurance,3350,52
Peach,Election Day,3620,Commissioner Of Insurance,3603,17
Peach,Provisional,8,Commissioner Of Insurance,8,0
Pickens,Absentee by Mail,138,Commissioner Of Insurance,136,2
Pickens,Advance in Person,3653,Commissioner Of Insurance,3609,44
Pickens,Election Day,5031,Commissioner Of Insurance,4995,36
Pickens,Provisional,1,Commissioner Of Insurance,1,0
Pierce,Absentee by Mail,228,Commissioner Of Insurance,223,5
Pierce,Advance in Person,1629,Commissioner Of Insurance,1606,23
Pierce,Election Day,2106,Commissioner Of Insurance,2100,6
Pierce,Provisional,0,Commissioner Of Insurance,0,0
Pike,Absentee by Mail,246,Commissioner Of Insurance,236,10
Pike,Advance in Person,1650,Commissioner Of Insurance,1641,9
Pike,Election Day,3700,Commissioner Of Insurance,3673,27
Pike,Provisional,8,Commissioner Of Insurance,8,0
Polk,Absentee by Mail,235,Commissioner Of Insurance,233,2
Polk,Advance in Person,3214,Commissioner Of Insurance,3208,6
Polk,Election Day,4537,Commissioner Of Insurance,4483,54
Polk,Provisional,4,Commissioner Of Insurance,4,0
Pulaski,Absentee by Mail,86,Commissioner Of Insurance,84,2
Pulaski,Advance in Person,1249,Commissioner Of Insurance,1217,32
Pulaski,Election Day,1013,Commissioner Of Insurance,988,25
Pulaski,Provisional,2,Commissioner Of Insurance,2,0
Putnam,Absentee by Mail,387,Commissioner Of Insurance,382,5
Putnam,Advance in Person,2434,Commissioner Of Insurance,2407,27
Putnam,Election Day,3451,Commissioner Of Insurance,3436,15
Putnam,Provisional,2,Commissioner Of Insurance,2,0
Quitman,Absentee by Mail,41,Commissioner Of Insurance,40,1
Quitman,Advance in Person,209,Commissioner Of Insurance,201,8
Quitman,Election Day,347,Commissioner Of Insurance,339,8
Quitman,Provisional,1,Commissioner Of Insurance,1,0
Rabun,Absentee by Mail,427,Commissioner Of Insurance,413,14
Rabun,Advance in Person,3295,Commissioner Of Insurance,3214,81
Rabun,Election Day,1731,Commissioner Of Insurance,1682,49
Rabun,Provisional,0,Commissioner Of Insurance,0,0
Randolph,Absentee by Mail,149,Commissioner Of Insurance,144,5
Randolph,Advance in Person,789,Commissioner Of Insurance,774,15
Randolph,Election Day,1173,Commissioner Of Insurance,1157,16
Randolph,Provisional,7,Commissioner Of Insurance,7,0
Richmond,Absentee by Mail,3207,Commissioner Of Insurance,3168,39
Richmond,Advance in Person,13314,Commissioner Of Insurance,13231,83
Richmond,Election Day,31248,Commissioner Of Insurance,31002,246
Richmond,Provisional,71,Commissioner Of Insurance,71,0
Rockdale,Absentee by Mail,825,Commissioner Of Insurance,811,14
Rockdale,Advance in Person,13442,Commissioner Of Insurance,13390,52
Rockdale,Election Day,12256,Commissioner Of Insurance,12206,50
Rockdale,Provisional,48,Commissioner Of Insurance,48,0
Schley,Absentee by Mail,66,Commissioner Of Insurance,64,2
Schley,Advance in Person,602,Commissioner Of Insurance,597,5
Schley,Election Day,595,Commissioner Of Insurance,581,14
Schley,Provisional,3,Commissioner Of Insurance,3,0
Screven,Absentee by Mail,158,Commissioner Of Insurance,153,5
Screven,Advance in Person,1201,Commissioner Of Insurance,1179,22
Screven,Election Day,2412,Commissioner Of Insurance,2402,10
Screven,Provisional,4,Commissioner Of Insurance,4,0
Seminole,Absentee by Mail,76,Commissioner Of Insurance,74,2
Seminole,Advance in Person,477,Commissioner Of Insurance,470,7
Seminole,Election Day,1698,Commissioner Of Insurance,1670,28
Seminole,Provisional,5,Commissioner Of Insurance,5,0
Spalding,Absentee by Mail,528,Commissioner Of Insurance,516,12
Spalding,Advance in Person,6771,Commissioner Of Insurance,6689,82
Spalding,Election Day,9378,Commissioner Of Insurance,9298,80
Spalding,Provisional,14,Commissioner Of Insurance,14,0
Stephens,Absentee by Mail,337,Commissioner Of Insurance,333,4
Stephens,Advance in Person,2604,Commissioner Of Insurance,2598,6
Stephens,Election Day,2225,Commissioner Of Insurance,2208,17
Stephens,Provisional,2,Commissioner Of Insurance,2,0
Stewart,Absentee by Mail,75,Commissioner Of Insurance,73,2
Stewart,Advance in Person,311,Commissioner Of Insurance,293,18
Stewart,Election Day,808,Commissioner Of Insurance,781,27
Stewart,Provisional,18,Commissioner Of Insurance,18,0
Sumter,Absentee by Mail,522,Commissioner Of Insurance,511,11
Sumter,Advance in Person,3280,Commissioner Of Insurance,3248,32
Sumter,Election Day,4191,Commissioner Of Insurance,4118,73
Sumter,Provisional,5,Commissioner Of Insurance,5,0
Talbot,Absentee by Mail,215,Commissioner Of Insurance,202,13
Talbot,Advance in Person,342,Commissioner Of Insurance,336,6
Talbot,Election Day,1588,Commissioner Of Insurance,1553,35
Talbot,Provisional,2,Commissioner Of Insurance,2,0
Taliaferro,Absentee by Mail,50,Commissioner Of Insurance,49,1
Taliaferro,Advance in Person,197,Commissioner Of Insurance,193,4
Taliaferro,Election Day,311,Commissioner Of Insurance,306,5
Taliaferro,Provisional,0,Commissioner Of Insurance,0,0
Tattnall,Absentee by Mail,198,Commissioner Of Insurance,195,3
Tattnall,Advance in Person,1310,Commissioner Of Insurance,1279,31
Tattnall,Election Day,2706,Commissioner Of Insurance,2663,43
Tattnall,Provisional,6,Commissioner Of Insurance,6,0
Taylor,Absentee by Mail,127,Commissioner Of Insurance,126,1
Taylor,Advance in Person,620,Commissioner Of Insurance,610,10
Taylor,Election Day,1441,Commissioner Of Insurance,1413,28
Taylor,Provisional,0,Commissioner Of Insurance,0,0
Telfair,Absentee by Mail,227,Commissioner Of Insurance,225,2
Telfair,Advance in Person,751,Commissioner Of Insurance,721,30
Telfair,Election Day,1723,Commissioner Of Insurance,1694,29
Telfair,Provisional,0,Commissioner Of Insurance,0,0
Terrell,Absentee by Mail,258,Commissioner Of Insurance,241,17
Terrell,Advance in Person,1101,Commissioner Of Insurance,1064,37
Terrell,Election Day,1887,Commissioner Of Insurance,1867,20
Terrell,Provisional,2,Commissioner Of Insurance,2,0
Thomas,Absentee by Mail,293,Commissioner Of Insurance,290,3
Thomas,Advance in Person,3653,Commissioner Of Insurance,3634,19
Thomas,Election Day,7055,Commissioner Of Insurance,7016,39
Thomas,Provisional,2,Commissioner Of Insurance,2,0
Tift,Absentee by Mail,254,Commissioner Of Insurance,251,3
Tift,Advance in Person,3128,Commissioner Of Insurance,3110,18
Tift,Election Day,5030,Commissioner Of Insurance,4938,92
Tift,Provisional,92,Commissioner Of Insurance,90,2
Toombs,Absentee by Mail,381,Commissioner Of Insurance,377,4
Toombs,Advance in Person,1805,Commissioner Of Insurance,1777,28
Toombs,Election Day,3352,Commissioner Of Insurance,3325,27
Toombs,Provisional,6,Commissioner Of Insurance,6,0
Towns,Absentee by Mail,190,Commissioner Of Insurance,181,9
Towns,Advance in Person,2289,Commissioner Of Insurance,2249,40
Towns,Election Day,1717,Commissioner Of Insurance,1698,19
Towns,Provisional,68,Commissioner Of Insurance,65,3
Treutlen,Absentee by Mail,50,Commissioner Of Insurance,48,2
Treutlen,Advance in Person,426,Commissioner Of Insurance,420,6
Treutlen,Election Day,1041,Commissioner Of Insurance,1028,13
Treutlen,Provisional,3,Commissioner Of Insurance,3,0
Troup,Absentee by Mail,847,Commissioner Of Insurance,834,13
Troup,Advance in Person,4821,Commissioner Of Insurance,4797,24
Troup,Election Day,9963,Commissioner Of Insurance,9920,43
Troup,Provisional,41,Commissioner Of Insurance,38,3
Turner,Absentee by Mail,41,Commissioner Of Insurance,38,3
Turner,Advance in Person,1026,Commissioner Of Insurance,1018,8
Turner,Election Day,1188,Commissioner Of Insurance,1165,23
Turner,Provisional,11,Commissioner Of Insurance,11,0
Twiggs,Absentee by Mail,275,Commissioner Of Insurance,272,3
Twiggs,Advance in Person,841,Commissioner Of Insurance,832,9
Twiggs,Election Day,1776,Commissioner Of Insurance,1744,32
Twiggs,Provisional,1,Commissioner Of Insurance,1,0
Union,Absentee by Mail,288,Commissioner Of Insurance,277,11
Union,Advance in Person,3487,Commissioner Of Insurance,3443,44
Union,Election Day,3966,Commissioner Of Insurance,3891,75
Union,Provisional,2,Commissioner Of Insurance,2,0
Upson,Absentee by Mail,230,Commissioner Of Insurance,221,9
Upson,Advance in Person,2400,Commissioner Of Insurance,2380,20
Upson,Election Day,4440,Commissioner Of Insurance,4423,17
Upson,Provisional,1,Commissioner Of Insurance,1,0
Walker,Absentee by Mail,617,Commissioner Of Insurance,598,19
Walker,Advance in Person,3646,Commissioner Of Insurance,3612,34
Walker,Election Day,8076,Commissioner Of Insurance,8002,74
Walker,Provisional,0,Commissioner Of Insurance,0,0
Walton,Absentee by Mail,1068,Commissioner Of Insurance,1046,22
Walton,Advance in Person,6096,Commissioner Of Insurance,6063,33
Walton,Election Day,18659,Commissioner Of Insurance,18513,146
Walton,Provisional,16,Commissioner Of Insurance,16,0
Ware,Absentee by Mail,326,Commissioner Of Insurance,322,4
Ware,Advance in Person,2081,Commissioner Of Insurance,2073,8
Ware,Election Day,4306,Commissioner Of Insurance,4261,45
Ware,Provisional,1,Commissioner Of Insurance,1,0
Warren,Absentee by Mail,60,Commissioner Of Insurance,59,1
Warren,Advance in Person,543,Commissioner Of Insurance,530,13
Warren,Election Day,889,Commissioner Of Insurance,882,7
Warren,Provisional,1,Commissioner Of Insurance,1,0
Washington,Absentee by Mail,355,Commissioner Of Insurance,342,13
Washington,Advance in Person,2324,Commissioner Of Insurance,2261,63
Washington,Election Day,3362,Commissioner Of Insurance,3275,87
Washington,Provisional,8,Commissioner Of Insurance,8,0
Wayne,Absentee by Mail,258,Commissioner Of Insurance,250,8
Wayne,Advance in Person,2152,Commissioner Of Insurance,2130,22
Wayne,Election Day,3740,Commissioner Of Insurance,3706,34
Wayne,Provisional,0,Commissioner Of Insurance,0,0
Webster,Absentee by Mail,80,Commissioner Of Insurance,76,4
Webster,Advance in Person,271,Commissioner Of Insurance,263,8
Webster,Election Day,426,Commissioner Of Insurance,407,19
Webster,Provisional,0,Commissioner Of Insurance,0,0
Wheeler,Absentee by Mail,87,Commissioner Of Insurance,84,3
Wheeler,Advance in Person,447,Commissioner Of Insurance,428,19
Wheeler,Election Day,959,Commissioner Of Insurance,947,12
Wheeler,Provisional,9,Commissioner Of Insurance,8,1
White,Absentee by Mail,447,Commissioner Of Insurance,433,14
White,Advance in Person,2267,Commissioner Of Insurance,2247,20
White,Election Day,4948,Commissioner Of Insurance,4897,51
White,Provisional,3,Commissioner Of Insurance,3,0
Whitfield,Absentee by Mail,478,Commissioner Of Insurance,466,12
Whitfield,Advance in Person,3511,Commissioner Of Insurance,3452,59
Whitfield,Election Day,11767,Commissioner Of Insurance,11564,203
Whitfield,Provisional,38,Commissioner Of Insurance,38,0
Wilcox,Absentee by Mail,144,Commissioner Of Insurance,142,2
Wilcox,Advance in Person,455,Commissioner Of Insurance,449,6
Wilcox,Election Day,1280,Commissioner Of Insurance,1262,18
Wilcox,Provisional,3,Commissioner Of Insurance,3,0
Wilkes,Absentee by Mail,104,Commissioner Of Insurance,102,2
Wilkes,Advance in Person,939,Commissioner Of Insurance,938,1
Wilkes,Election Day,2044,Commissioner Of Insurance,2037,7
Wilkes,Provisional,3,Commissioner Of Insurance,3,0
Wilkinson,Absentee by Mail,150,Commissioner Of Insurance,149,1
Wilkinson,Advance in Person,763,Commissioner Of Insurance,749,14
Wilkinson,Election Day,2227,Commissioner Of Insurance,2195,32
Wilkinson,Provisional,1,Commissioner Of Insurance,1,0
Worth,Absentee by Mail,138,Commissioner Of Insurance,136,2
Worth,Advance in Person,1170,Commissioner Of Insurance,1169,1
Worth,Election Day,3871,Commissioner Of Insurance,3851,20
Worth,Provisional,10,Commissioner Of Insurance,10,0
Appling,Absentee by Mail,306,State School Superintendent,302,4
Appling,Advance in Person,976,State School Superintendent,972,4
Appling,Election Day,3122,State School Superintendent,3116,6
Appling,Provisional,4,State School Superintendent,4,0
Atkinson,Absentee by Mail,68,State School Superintendent,67,1
Atkinson,Advance in Person,495,State School Superintendent,485,10
Atkinson,Election Day,1058,State School Superintendent,1026,32
Atkinson,Provisional,7,State School Superintendent,7,0
Bacon,Absentee by Mail,73,State School Superintendent,72,1
Bacon,Advance in Person,887,State School Superintendent,873,14
Bacon,Election Day,1240,State School Superintendent,1240,0
Bacon,Provisional,3,State School Superintendent,3,0
Baker,Absentee by Mail,71,State School Superintendent,68,3
Baker,Advance in Person,298,State School Superintendent,296,2
Baker,Election Day,617,State School Superintendent,600,17
Baker,Provisional,3,State School Superintendent,3,0
Baldwin,Absentee by Mail,409,State School Superintendent,406,3
Baldwin,Advance in Person,3933,State School Superintendent,3903,30
Baldwin,Election Day,6152,State School Superintendent,6152,0
Baldwin,Provisional,9,State School Superintendent,9,0
Banks,Absentee by Mail,142,State School Superintendent,138,4
Banks,Advance in Person,852,State School Superintendent,834,18
Banks,Election Day,3339,State School Superintendent,3271,68
Banks,Provisional,1,State School Superintendent,1,0
Barrow,Absentee by Mail,701,State School Superintendent,689,12
Barrow,Advance in Person,4720,State School Superintendent,4698,22
Barrow,Election Day,10688,State School Superintendent,10574,114
Barrow,Provisional,8,State School Superintendent,6,2
Bartow,Absentee by Mail,772,State School Superintendent,756,16
Bartow,Advance in Person,5826,State School Superintendent,5807,19
Bartow,Election Day,16152,State School Superintendent,15986,166
Bartow,Provisional,20,State School Superintendent,19,1
Ben Hill,Absentee by Mail,136,State School Superintendent,132,4
Ben Hill,Advance in Person,1494,State School Superintendent,1494,0
Ben Hill,Election Day,1864,State School Superintendent,1864,0
Ben Hill,Provisional,3,State School Superintendent,3,0
Berrien,Absentee by Mail,212,State School Superintendent,210,2
Berrien,Advance in Person,1103,State School Superintendent,1103,0
Berrien,Election Day,2608,State School Superintendent,2608,0
Berrien,Provisional,8,State School Superintendent,8,0
Bibb,Absentee by Mail,2189,State School Superintendent,2155,34
Bibb,Advance in Person,10315,State School Superintendent,10280,35
Bibb,Election Day,29989,State School Superintendent,29714,275
Bibb,Provisional,78,State School Superintendent,77,1
Bleckley,Absentee by Mail,228,State School Superintendent,219,9
Bleckley,Advance in Person,1157,State School Superintendent,1136,21
Bleckley,Election Day,1855,State School Superintendent,1846,9
Bleckley,Provisional,5,State School Superintendent,4,1
Brantley,Absentee by Mail,143,State School Superintendent,142,1
Brantley,Advance in Person,747,State School Superintendent,744,3
Brantley,Election Day,2086,State School Superintendent,2084,2
Brantley,Provisional,4,State School Superintendent,4,0
Brooks,Absentee by Mail,1016,State School Superintendent,1000,16
Brooks,Advance in Person,1259,State School Superintendent,1247,12
Brooks,Election Day,2355,State School Superintendent,2344,11
Brooks,Provisional,26,State School Superintendent,26,0
Bryan,Absentee by Mail,237,State School Superintendent,231,6
Bryan,Advance in Person,2852,State School Superintendent,2833,19
Bryan,Election Day,4863,State School Superintendent,4848,15
Bryan,Provisional,3,State School Superintendent,3,0
Bulloch,Absentee by Mail,541,State School Superintendent,529,12
Bulloch,Advance in Person,3846,State School Superintendent,3827,19
Bulloch,Election Day,9455,State School Superintendent,9413,42
Bulloch,Provisional,12,State School Superintendent,11,1
Burke,Absentee by Mail,594,State School Superintendent,594,0
Burke,Advance in Person,1260,State School Superintendent,1260,0
Burke,Election Day,4049,State School Superintendent,4049,0
Burke,Provisional,0,State School Superintendent,0,0
Butts,Absentee by Mail,183,State School Superintendent,183,0
Butts,Advance in Person,3252,State School Superintendent,3212,40
Butts,Election Day,2671,State School Superintendent,2636,35
Butts,Provisional,0,State School Superintendent,0,0
Calhoun,Absentee by Mail,91,State School Superintendent,91,0
Calhoun,Advance in Person,320,State School Superintendent,319,1
Calhoun,Election Day,1044,State School Superintendent,1041,3
Calhoun,Provisional,2,State School Superintendent,1,1
Camden,Absentee by Mail,586,State School Superintendent,582,4
Camden,Advance in Person,2509,State School Superintendent,2509,0
Camden,Election Day,6720,State School Superintendent,6707,13
Camden,Provisional,9,State School Superintendent,9,0
Candler,Absentee by Mail,108,State School Superintendent,106,2
Candler,Advance in Person,835,State School Superintendent,835,0
Candler,Election Day,1258,State School Superintendent,1251,7
Candler,Provisional,0,State School Superintendent,0,0
Carroll,Absentee by Mail,845,State School Superintendent,827,18
Carroll,Advance in Person,7673,State School Superintendent,7618,55
Carroll,Election Day,17495,State School Superintendent,17413,82
Carroll,Provisional,53,State School Superintendent,52,1
Catoosa,Absentee by Mail,456,State School Superintendent,445,11
Catoosa,Advance in Person,4909,State School Superintendent,4872,37
Catoosa,Election Day,8541,State School Superintendent,8450,91
Catoosa,Provisional,14,State School Superintendent,14,0
Charlton,Absentee by Mail,80,State School Superintendent,80,0
Charlton,Advance in Person,684,State School Superintendent,684,0
Charlton,Election Day,1247,State School Superintendent,1246,1
Charlton,Provisional,4,State School Superintendent,4,0
Chatham,Absentee by Mail,2948,State School Superintendent,2873,75
Chatham,Advance in Person,17241,State School Superintendent,17224,17
Chatham,Election Day,48480,State School Superintendent,48415,65
Chatham,Provisional,55,State School Superintendent,53,2
Chattahoochee,Absentee by Mail,22,State School Superintendent,21,1
Chattahoochee,Advance in Person,196,State School Superintendent,192,4
Chattahoochee,Election Day,481,State School Superintendent,480,1
Chattahoochee,Provisional,2,State School Superintendent,2,0
Chattooga,Absentee by Mail,107,State School Superintendent,104,3
Chattooga,Advance in Person,1625,State School Superintendent,1611,14
Chattooga,Election Day,3090,State School Superintendent,3061,29
Chattooga,Provisional,2,State School Superintendent,2,0
Cherokee,Absentee by Mail,2440,State School Superintendent,2369,71
Cherokee,Advance in Person,23437,State School Superintendent,23046,391
Cherokee,Election Day,40811,State School Superintendent,40003,808
Cherokee,Provisional,31,State School Superintendent,31,0
Clarke,Absentee by Mail,1152,State School Superintendent,1110,42
Clarke,Advance in Person,7332,State School Superintendent,7231,101
Clarke,Election Day,16976,State School Superintendent,16573,403
Clarke,Provisional,76,State School Superintendent,72,4
Clay,Absentee by Mail,90,State School Superintendent,89,1
Clay,Advance in Person,244,State School Superintendent,244,0
Clay,Election Day,602,State School Superintendent,597,5
Clay,Provisional,1,State School Superintendent,1,0
Clayton,Absentee by Mail,1772,State School Superintendent,1752,20
Clayton,Advance in Person,25878,State School Superintendent,25878,0
Clayton,Election Day,34794,State School Superintendent,34794,0
Clayton,Provisional,66,State School Superintendent,64,2
Clinch,Absentee by Mail,53,State School Superintendent,52,1
Clinch,Advance in Person,340,State School Superintendent,340,0
Clinch,Election Day,777,State School Superintendent,773,4
Clinch,Provisional,2,State School Superintendent,2,0
Cobb,Absentee by Mail,10616,State School Superintendent,10307,309
Cobb,Advance in Person,58755,State School Superintendent,57805,950
Cobb,Election Day,143123,State School Superintendent,139696,3427
Cobb,Provisional,581,State School Superintendent,562,19
Coffee,Absentee by Mail,328,State School Superintendent,323,5
Coffee,Advance in Person,3477,State School Superintendent,3477,0
Coffee,Election Day,4390,State School Superintendent,4376,14
Coffee,Provisional,7,State School Superintendent,7,0
Colquitt,Absentee by Mail,172,State School Superintendent,171,1
Colquitt,Advance in Person,2409,State School Superintendent,2409,0
Colquitt,Election Day,5359,State School Superintendent,5359,0
Colquitt,Provisional,4,State School Superintendent,4,0
Columbia,Absentee by Mail,1698,State School Superintendent,1666,32
Columbia,Advance in Person,11710,State School Superintendent,11697,13
Columbia,Election Day,26403,State School Superintendent,26372,31
Columbia,Provisional,10,State School Superintendent,10,0
Cook,Absentee by Mail,113,State School Superintendent,113,0
Cook,Advance in Person,1115,State School Superintendent,1107,8
Cook,Election Day,2316,State School Superintendent,2316,0
Cook,Provisional,0,State School Superintendent,0,0
Coweta,Absentee by Mail,1733,State School Superintendent,1700,33
Coweta,Advance in Person,9167,State School Superintendent,9104,63
Coweta,Election Day,26256,State School Superintendent,26090,166
Coweta,Provisional,15,State School Superintendent,15,0
Crawford,Absentee by Mail,146,State School Superintendent,144,2
Crawford,Advance in Person,1092,State School Superintendent,1085,7
Crawford,Election Day,2012,State School Superintendent,2006,6
Crawford,Provisional,4,State School Superintendent,4,0
Crisp,Absentee by Mail,169,State School Superintendent,165,4
Crisp,Advance in Person,2060,State School Superintendent,2026,34
Crisp,Election Day,2752,State School Superintendent,2742,10
Crisp,Provisional,2,State School Superintendent,2,0
Dade,Absentee by Mail,114,State School Superintendent,108,6
Dade,Advance in Person,1030,State School Superintendent,998,32
Dade,Election Day,2283,State School Superintendent,2208,75
Dade,Provisional,9,State School Superintendent,9,0
Dawson,Absentee by Mail,311,State School Superintendent,304,7
Dawson,Advance in Person,3231,State School Superintendent,3169,62
Dawson,Election Day,3731,State School Superintendent,3655,76
Dawson,Provisional,11,State School Superintendent,10,1
DeKalb,Absentee by Mail,8280,State School Superintendent,7994,286
DeKalb,Advance in Person,72480,State School Superintendent,71987,493
DeKalb,Election Day,129376,State School Superintendent,126936,2440
DeKalb,Provisional,503,State School Superintendent,495,8
Decatur,Absentee by Mail,269,State School Superintendent,267,2
Decatur,Advance in Person,1985,State School Superintendent,1984,1
Decatur,Election Day,3820,State School Superintendent,3814,6
Decatur,Provisional,5,State School Superintendent,5,0
Dodge,Absentee by Mail,219,State School Superintendent,215,4
Dodge,Advance in Person,1690,State School Superintendent,1649,41
Dodge,Election Day,3173,State School Superintendent,3118,55
Dodge,Provisional,0,State School Superintendent,0,0
Dooly,Absentee by Mail,68,State School Superintendent,66,2
Dooly,Advance in Person,834,State School Superintendent,802,32
Dooly,Election Day,1783,State School Superintendent,1767,16
Dooly,Provisional,0,State School Superintendent,0,0
Dougherty,Absentee by Mail,1050,State School Superintendent,1033,17
Dougherty,Advance in Person,6272,State School Superintendent,6272,0
Dougherty,Election Day,16148,State School Superintendent,16136,12
Dougherty,Provisional,41,State School Superintendent,39,2
Douglas,Absentee by Mail,1308,State School Superintendent,1286,22
Douglas,Advance in Person,15797,State School Superintendent,15757,40
Douglas,Election Day,20398,State School Superintendent,20376,22
Douglas,Provisional,27,State School Superintendent,27,0
Early,Absentee by Mail,140,State School Superintendent,139,1
Early,Advance in Person,890,State School Superintendent,890,0
Early,Election Day,2163,State School Superintendent,2158,5
Early,Provisional,3,State School Superintendent,3,0
Echols,Absentee by Mail,19,State School Superintendent,19,0
Echols,Advance in Person,243,State School Superintendent,238,5
Echols,Election Day,361,State School Superintendent,360,1
Echols,Provisional,0,State School Superintendent,0,0
Effingham,Absentee by Mail,373,State School Superintendent,371,2
Effingham,Advance in Person,3036,State School Superintendent,3031,5
Effingham,Election Day,9204,State School Superintendent,9158,46
Effingham,Provisional,10,State School Superintendent,10,0
Elbert,Absentee by Mail,219,State School Superintendent,216,3
Elbert,Advance in Person,1841,State School Superintendent,1841,0
Elbert,Election Day,2632,State School Superintendent,2626,6
Elbert,Provisional,11,State School Superintendent,11,0
Emanuel,Absentee by Mail,213,State School Superintendent,207,6
Emanuel,Advance in Person,1187,State School Superintendent,1187,0
Emanuel,Election Day,3581,State School Superintendent,3581,0
Emanuel,Provisional,1,State School Superintendent,1,0
Evans,Absentee by Mail,122,State School Superintendent,116,6
Evans,Advance in Person,921,State School Superintendent,913,8
Evans,Election Day,1107,State School Superintendent,1098,9
Evans,Provisional,0,State School Superintendent,0,0
Fannin,Absentee by Mail,417,State School Superintendent,408,9
Fannin,Advance in Person,2268,State School Superintendent,2224,44
Fannin,Election Day,4216,State School Superintendent,4131,85
Fannin,Provisional,3,State School Superintendent,3,0
Fayette,Absentee by Mail,1272,State School Superintendent,1239,33
Fayette,Advance in Person,18189,State School Superintendent,17990,199
Fayette,Election Day,22606,State School Superintendent,22264,342
Fayette,Provisional,13,State School Superintendent,13,0
Floyd,Absentee by Mail,771,State School Superintendent,749,22
Floyd,Advance in Person,5763,State School Superintendent,5733,30
Floyd,Election Day,14210,State School Superintendent,14064,146
Floyd,Provisional,78,State School Superintendent,76,2
Forsyth,Absentee by Mail,1655,State School Superintendent,1605,50
Forsyth,Advance in Person,22647,State School Superintendent,22303,344
Forsyth,Election Day,32220,State School Superintendent,31723,497
Forsyth,Provisional,48,State School Superintendent,45,3
Franklin,Absentee by Mail,198,State School Superintendent,194,4
Franklin,Advance in Person,1077,State School Superintendent,1071,6
Franklin,Election Day,3454,State School Superintendent,3454,0
Franklin,Provisional,1,State School Superintendent,1,0
Fulton,Absentee by Mail,8864,State School Superintendent,8567,297
Fulton,Advance in Person,87201,State School Superintendent,86022,1179
Fulton,Election Day,167468,State School Superintendent,163760,3708
Fulton,Provisional,2135,State School Superintendent,2059,76
Gilmer,Absentee by Mail,378,State School Superintendent,373,5
Gilmer,Advance in Person,2578,State School Superintendent,2523,55
Gilmer,Election Day,4854,State School Superintendent,4723,131
Gilmer,Provisional,16,State School Superintendent,14,2
Glascock,Absentee by Mail,36,State School Superintendent,34,2
Glascock,Advance in Person,211,State School Superintendent,208,3
Glascock,Election Day,542,State School Superintendent,538,4
Glascock,Provisional,0,State School Superintendent,0,0
Glynn,Absentee by Mail,883,State School Superintendent,867,16
Glynn,Advance in Person,7098,State School Superintendent,7089,9
Glynn,Election Day,12102,State School Superintendent,12069,33
Glynn,Provisional,36,State School Superintendent,34,2
Gordon,Absentee by Mail,370,State School Superintendent,361,9
Gordon,Advance in Person,2666,State School Superintendent,2585,81
Gordon,Election Day,7273,State School Superintendent,7094,179
Gordon,Provisional,16,State School Superintendent,14,2
Grady,Absentee by Mail,157,State School Superintendent,156,1
Grady,Advance in Person,1854,State School Superintendent,1835,19
Grady,Election Day,3548,State School Superintendent,3548,0
Grady,Provisional,6,State School Superintendent,6,0
Greene,Absentee by Mail,538,State School Superintendent,531,7
Greene,Advance in Person,3068,State School Superintendent,3035,33
Greene,Election Day,2907,State School Superintendent,2848,59
Greene,Provisional,10,State School Superintendent,10,0
Gwinnett,Absentee by Mail,8170,State School Superintendent,7958,212
Gwinnett,Advance in Person,47244,State School Superintendent,46935,309
Gwinnett,Election Day,141636,State School Superintendent,139866,1770
Gwinnett,Provisional,1155,State School Superintendent,1124,31
Habersham,Absentee by Mail,704,State School Superintendent,687,17
Habersham,Advance in Person,5381,State School Superintendent,5246,135
Habersham,Election Day,3529,State School Superintendent,3466,63
Habersham,Provisional,34,State School Superintendent,32,2
Hall,Absentee by Mail,2074,State School Superintendent,2024,50
Hall,Advance in Person,12299,State School Superintendent,12122,177
Hall,Election Day,29428,State School Superintendent,28923,505
Hall,Provisional,42,State School Superintendent,40,2
Hancock,Absentee by Mail,283,State School Superintendent,282,1
Hancock,Advance in Person,839,State School Superintendent,838,1
Hancock,Election Day,1257,State School Superintendent,1250,7
Hancock,Provisional,19,State School Superintendent,17,2
Haralson,Absentee by Mail,262,State School Superintendent,255,7
Haralson,Advance in Person,1563,State School Superintendent,1541,22
Haralson,Election Day,4986,State School Superintendent,4940,46
Haralson,Provisional,2,State School Superintendent,2,0
Harris,Absentee by Mail,493,State School Superintendent,487,6
Harris,Advance in Person,2950,State School Superintendent,2948,2
Harris,Election Day,6803,State School Superintendent,6803,0
Harris,Provisional,2,State School Superintendent,2,0
Hart,Absentee by Mail,287,State School Superintendent,280,7
Hart,Advance in Person,2309,State School Superintendent,2234,75
Hart,Election Day,4185,State School Superintendent,4154,31
Hart,Provisional,1,State School Superintendent,1,0
Heard,Absentee by Mail,157,State School Superintendent,153,4
Heard,Advance in Person,552,State School Superintendent,545,7
Heard,Election Day,1772,State School Superintendent,1752,20
Heard,Provisional,0,State School Superintendent,0,0
Henry,Absentee by Mail,2016,State School Superintendent,1978,38
Henry,Advance in Person,29231,State School Superintendent,29231,0
Henry,Election Day,31732,State School Superintendent,31624,108
Henry,Provisional,102,State School Superintendent,100,2
Houston,Absentee by Mail,1431,State School Superintendent,1405,26
Houston,Advance in Person,16400,State School Superintendent,16357,43
Houston,Election Day,19454,State School Superintendent,19363,91
Houston,Provisional,62,State School Superintendent,58,4
Irwin,Absentee by Mail,61,State School Superintendent,60,1
Irwin,Advance in Person,719,State School Superintendent,719,0
Irwin,Election Day,1581,State School Superintendent,1581,0
Irwin,Provisional,3,State School Superintendent,3,0
Jackson,Absentee by Mail,495,State School Superintendent,487,8
Jackson,Advance in Person,5419,State School Superintendent,5379,40
Jackson,Election Day,10060,State School Superintendent,9948,112
Jackson,Provisional,16,State School Superintendent,14,2
Jasper,Absentee by Mail,255,State School Superintendent,250,5
Jasper,Advance in Person,1280,State School Superintendent,1276,4
Jasper,Election Day,2305,State School Superintendent,2302,3
Jasper,Provisional,2,State School Superintendent,2,0
Jeff Davis,Absentee by Mail,153,State School Superintendent,150,3
Jeff Davis,Advance in Person,861,State School Superintendent,849,12
Jeff Davis,Election Day,1973,State School Superintendent,1949,24
Jeff Davis,Provisional,1,State School Superintendent,1,0
Jefferson,Absentee by Mail,216,State School Superintendent,213,3
Jefferson,Advance in Person,1158,State School Superintendent,1157,1
Jefferson,Election Day,3144,State School Superintendent,3144,0
Jefferson,Provisional,20,State School Superintendent,20,0
Jenkins,Absentee by Mail,163,State School Superintendent,161,2
Jenkins,Advance in Person,671,State School Superintendent,671,0
Jenkins,Election Day,1088,State School Superintendent,1088,0
Jenkins,Provisional,0,State School Superintendent,0,0
Johnson,Absentee by Mail,92,State School Superintendent,92,0
Johnson,Advance in Person,789,State School Superintendent,789,0
Johnson,Election Day,1415,State School Superintendent,1414,1
Johnson,Provisional,0,State School Superintendent,0,0
Jones,Absentee by Mail,511,State School Superintendent,506,5
Jones,Advance in Person,2913,State School Superintendent,2913,0
Jones,Election Day,4638,State School Superintendent,4627,11
Jones,Provisional,7,State School Superintendent,7,0
Lamar,Absentee by Mail,215,State School Superintendent,208,7
Lamar,Advance in Person,1700,State School Superintendent,1680,20
Lamar,Election Day,3046,State School Superintendent,3042,4
Lamar,Provisional,5,State School Superintendent,5,0
Lanier,Absentee by Mail,40,State School Superintendent,40,0
Lanier,Advance in Person,521,State School Superintendent,514,7
Lanier,Election Day,878,State School Superintendent,876,2
Lanier,Provisional,4,State School Superintendent,4,0
Laurens,Absentee by Mail,763,State School Superintendent,751,12
Laurens,Advance in Person,3953,State School Superintendent,3953,0
Laurens,Election Day,8153,State School Superintendent,8089,64
Laurens,Provisional,14,State School Superintendent,13,1
Lee,Absentee by Mail,241,State School Superintendent,237,4
Lee,Advance in Person,2107,State School Superintendent,2101,6
Lee,Election Day,6514,State School Superintendent,6507,7
Lee,Provisional,5,State School Superintendent,5,0
Liberty,Absentee by Mail,209,State School Superintendent,204,5
Liberty,Advance in Person,3652,State School Superintendent,3652,0
Liberty,Election Day,5097,State School Superintendent,5097,0
Liberty,Provisional,4,State School Superintendent,3,1
Lincoln,Absentee by Mail,222,State School Superintendent,221,1
Lincoln,Advance in Person,899,State School Superintendent,893,6
Lincoln,Election Day,1554,State School Superintendent,1554,0
Lincoln,Provisional,13,State School Superintendent,13,0
Long,Absentee by Mail,40,State School Superintendent,40,0
Long,Advance in Person,691,State School Superintendent,687,4
Long,Election Day,1397,State School Superintendent,1377,20
Long,Provisional,6,State School Superintendent,6,0
Lowndes,Absentee by Mail,532,State School Superintendent,520,12
Lowndes,Advance in Person,8813,State School Superintendent,8811,2
Lowndes,Election Day,11478,State School Superintendent,11478,0
Lowndes,Provisional,560,State School Superintendent,558,2
Lumpkin,Absentee by Mail,305,State School Superintendent,295,10
Lumpkin,Advance in Person,2933,State School Superintendent,2891,42
Lumpkin,Election Day,4404,State School Superintendent,4331,73
Lumpkin,Provisional,15,State School Superintendent,14,1
Macon,Absentee by Mail,106,State School Superintendent,105,1
Macon,Advance in Person,1207,State School Superintendent,1169,38
Macon,Election Day,1695,State School Superintendent,1662,33
Macon,Provisional,0,State School Superintendent,0,0
Madison,Absentee by Mail,312,State School Superintendent,298,14
Madison,Advance in Person,2257,State School Superintendent,2220,37
Madison,Election Day,4970,State School Superintendent,4883,87
Madison,Provisional,6,State School Superintendent,6,0
Marion,Absentee by Mail,219,State School Superintendent,216,3
Marion,Advance in Person,612,State School Superintendent,600,12
Marion,Election Day,1314,State School Superintendent,1306,8
Marion,Provisional,0,State School Superintendent,0,0
McDuffie,Absentee by Mail,351,State School Superintendent,345,6
McDuffie,Advance in Person,2043,State School Superintendent,2043,0
McDuffie,Election Day,3653,State School Superintendent,3653,0
McDuffie,Provisional,3,State School Superintendent,3,0
McIntosh,Absentee by Mail,300,State School Superintendent,289,11
McIntosh,Advance in Person,1300,State School Superintendent,1292,8
McIntosh,Election Day,2233,State School Superintendent,2220,13
McIntosh,Provisional,7,State School Superintendent,6,1
Meriwether,Absentee by Mail,207,State School Superintendent,201,6
Meriwether,Advance in Person,1188,State School Superintendent,1188,0
Meriwether,Election Day,4671,State School Superintendent,4623,48
Meriwether,Provisional,1,State School Superintendent,1,0
Miller,Absentee by Mail,53,State School Superintendent,49,4
Miller,Advance in Person,436,State School Superintendent,430,6
Miller,Election Day,937,State School Superintendent,933,4
Miller,Provisional,1,State School Superintendent,1,0
Mitchell,Absentee by Mail,202,State School Superintendent,201,1
Mitchell,Advance in Person,1589,State School Superintendent,1589,0
Mitchell,Election Day,3215,State School Superintendent,3207,8
Mitchell,Provisional,3,State School Superintendent,3,0
Monroe,Absentee by Mail,358,State School Superintendent,353,5
Monroe,Advance in Person,2523,State School Superintendent,2503,20
Monroe,Election Day,5671,State School Superintendent,5626,45
Monroe,Provisional,23,State School Superintendent,22,1
Montgomery,Absentee by Mail,92,State School Superintendent,89,3
Montgomery,Advance in Person,463,State School Superintendent,452,11
Montgomery,Election Day,1730,State School Superintendent,1719,11
Montgomery,Provisional,0,State School Superintendent,0,0
Morgan,Absentee by Mail,193,State School Superintendent,188,5
Morgan,Advance in Person,2475,State School Superintendent,2456,19
Morgan,Election Day,3635,State School Superintendent,3602,33
Morgan,Provisional,7,State School Superintendent,6,1
Murray,Absentee by Mail,207,State School Superintendent,194,13
Murray,Advance in Person,1347,State School Superintendent,1317,30
Murray,Election Day,4497,State School Superintendent,4433,64
Murray,Provisional,0,State School Superintendent,0,0
Muscogee,Absentee by Mail,2150,State School Superintendent,2121,29
Muscogee,Advance in Person,13494,State School Superintendent,13471,23
Muscogee,Election Day,25301,State School Superintendent,25286,15
Muscogee,Provisional,63,State School Superintendent,63,0
Newton,Absentee by Mail,1136,State School Superintendent,1108,28
Newton,Advance in Person,10430,State School Superintendent,10424,6
Newton,Election Day,16634,State School Superintendent,16628,6
Newton,Provisional,2,State School Superintendent,2,0
Oconee,Absentee by Mail,368,State School Superintendent,352,16
Oconee,Advance in Person,5438,State School Superintendent,5316,122
Oconee,Election Day,7726,State School Superintendent,7466,260
Oconee,Provisional,7,State School Superintendent,7,0
Oglethorpe,Absentee by Mail,217,State School Superintendent,214,3
Oglethorpe,Advance in Person,1609,State School Superintendent,1588,21
Oglethorpe,Election Day,2262,State School Superintendent,2245,17
Oglethorpe,Provisional,4,State School Superintendent,4,0
Paulding,Absentee by Mail,1789,State School Superintendent,1740,49
Paulding,Advance in Person,14824,State School Superintendent,14770,54
Paulding,Election Day,19620,State School Superintendent,19520,100
Paulding,Provisional,29,State School Superintendent,26,3
Peach,Absentee by Mail,215,State School Superintendent,211,4
Peach,Advance in Person,3402,State School Superintendent,3392,10
Peach,Election Day,3620,State School Superintendent,3615,5
Peach,Provisional,8,State School Superintendent,8,0
Pickens,Absentee by Mail,138,State School Superintendent,135,3
Pickens,Advance in Person,3653,State School Superintendent,3582,71
Pickens,Election Day,5031,State School Superintendent,4981,50
Pickens,Provisional,1,State School Superintendent,1,0
Pierce,Absentee by Mail,228,State School Superintendent,224,4
Pierce,Advance in Person,1629,State School Superintendent,1629,0
Pierce,Election Day,2106,State School Superintendent,2106,0
Pierce,Provisional,0,State School Superintendent,0,0
Pike,Absentee by Mail,246,State School Superintendent,238,8
Pike,Advance in Person,1650,State School Superintendent,1633,17
Pike,Election Day,3700,State School Superintendent,3675,25
Pike,Provisional,8,State School Superintendent,8,0
Polk,Absentee by Mail,235,State School Superintendent,231,4
Polk,Advance in Person,3214,State School Superintendent,3173,41
Polk,Election Day,4537,State School Superintendent,4486,51
Polk,Provisional,4,State School Superintendent,4,0
Pulaski,Absentee by Mail,86,State School Superintendent,84,2
Pulaski,Advance in Person,1249,State School Superintendent,1235,14
Pulaski,Election Day,1013,State School Superintendent,996,17
Pulaski,Provisional,2,State School Superintendent,2,0
Putnam,Absentee by Mail,387,State School Superintendent,384,3
Putnam,Advance in Person,2434,State School Superintendent,2415,19
Putnam,Election Day,3451,State School Superintendent,3422,29
Putnam,Provisional,2,State School Superintendent,2,0
Quitman,Absentee by Mail,41,State School Superintendent,41,0
Quitman,Advance in Person,209,State School Superintendent,209,0
Quitman,Election Day,347,State School Superintendent,347,0
Quitman,Provisional,1,State School Superintendent,1,0
Rabun,Absentee by Mail,427,State School Superintendent,411,16
Rabun,Advance in Person,3295,State School Superintendent,3189,106
Rabun,Election Day,1731,State School Superintendent,1648,83
Rabun,Provisional,0,State School Superintendent,0,0
Randolph,Absentee by Mail,149,State School Superintendent,146,3
Randolph,Advance in Person,789,State School Superintendent,786,3
Randolph,Election Day,1173,State School Superintendent,1166,7
Randolph,Provisional,7,State School Superintendent,7,0
Richmond,Absentee by Mail,3207,State School Superintendent,3158,49
Richmond,Advance in Person,13314,State School Superintendent,13314,0
Richmond,Election Day,31248,State School Superintendent,31248,0
Richmond,Provisional,71,State School Superintendent,70,1
Rockdale,Absentee by Mail,825,State School Superintendent,807,18
Rockdale,Advance in Person,13442,State School Superintendent,13410,32
Rockdale,Election Day,12256,State School Superintendent,12225,31
Rockdale,Provisional,48,State School Superintendent,48,0
Schley,Absentee by Mail,66,State School Superintendent,65,1
Schley,Advance in Person,602,State School Superintendent,595,7
Schley,Election Day,595,State School Superintendent,592,3
Schley,Provisional,3,State School Superintendent,3,0
Screven,Absentee by Mail,158,State School Superintendent,154,4
Screven,Advance in Person,1201,State School Superintendent,1201,0
Screven,Election Day,2412,State School Superintendent,2412,0
Screven,Provisional,4,State School Superintendent,4,0
Seminole,Absentee by Mail,76,State School Superintendent,73,3
Seminole,Advance in Person,477,State School Superintendent,473,4
Seminole,Election Day,1698,State School Superintendent,1698,0
Seminole,Provisional,5,State School Superintendent,5,0
Spalding,Absentee by Mail,528,State School Superintendent,514,14
Spalding,Advance in Person,6771,State School Superintendent,6692,79
Spalding,Election Day,9378,State School Superintendent,9314,64
Spalding,Provisional,14,State School Superintendent,14,0
Stephens,Absentee by Mail,337,State School Superintendent,328,9
Stephens,Advance in Person,2604,State School Superintendent,2590,14
Stephens,Election Day,2225,State School Superintendent,2218,7
Stephens,Provisional,2,State School Superintendent,2,0
Stewart,Absentee by Mail,75,State School Superintendent,74,1
Stewart,Advance in Person,311,State School Superintendent,296,15
Stewart,Election Day,808,State School Superintendent,785,23
Stewart,Provisional,18,State School Superintendent,18,0
Sumter,Absentee by Mail,522,State School Superintendent,520,2
Sumter,Advance in Person,3280,State School Superintendent,3268,12
Sumter,Election Day,4191,State School Superintendent,4159,32
Sumter,Provisional,5,State School Superintendent,5,0
Talbot,Absentee by Mail,215,State School Superintendent,209,6
Talbot,Advance in Person,342,State School Superintendent,342,0
Talbot,Election Day,1588,State School Superintendent,1580,8
Talbot,Provisional,2,State School Superintendent,1,1
Taliaferro,Absentee by Mail,50,State School Superintendent,50,0
Taliaferro,Advance in Person,197,State School Superintendent,197,0
Taliaferro,Election Day,311,State School Superintendent,307,4
Taliaferro,Provisional,0,State School Superintendent,0,0
Tattnall,Absentee by Mail,198,State School Superintendent,193,5
Tattnall,Advance in Person,1310,State School Superintendent,1288,22
Tattnall,Election Day,2706,State School Superintendent,2688,18
Tattnall,Provisional,6,State School Superintendent,6,0
Taylor,Absentee by Mail,127,State School Superintendent,125,2
Taylor,Advance in Person,620,State School Superintendent,608,12
Taylor,Election Day,1441,State School Superintendent,1441,0
Taylor,Provisional,0,State School Superintendent,0,0
Telfair,Absentee by Mail,227,State School Superintendent,226,1
Telfair,Advance in Person,751,State School Superintendent,735,16
Telfair,Election Day,1723,State School Superintendent,1708,15
Telfair,Provisional,0,State School Superintendent,0,0
Terrell,Absentee by Mail,258,State School Superintendent,249,9
Terrell,Advance in Person,1101,State School Superintendent,1079,22
Terrell,Election Day,1887,State School Superintendent,1877,10
Terrell,Provisional,2,State School Superintendent,2,0
Thomas,Absentee by Mail,293,State School Superintendent,286,7
Thomas,Advance in Person,3653,State School Superintendent,3653,0
Thomas,Election Day,7055,State School Superintendent,7055,0
Thomas,Provisional,2,State School Superintendent,2,0
Tift,Absentee by Mail,254,State School Superintendent,252,2
Tift,Advance in Person,3128,State School Superintendent,3128,0
Tift,Election Day,5030,State School Superintendent,5030,0
Tift,Provisional,92,State School Superintendent,90,2
Toombs,Absentee by Mail,381,State School Superintendent,380,1
Toombs,Advance in Person,1805,State School Superintendent,1793,12
Toombs,Election Day,3352,State School Superintendent,3352,0
Toombs,Provisional,6,State School Superintendent,6,0
Towns,Absentee by Mail,190,State School Superintendent,185,5
Towns,Advance in Person,2289,State School Superintendent,2253,36
Towns,Election Day,1717,State School Superintendent,1680,37
Towns,Provisional,68,State School Superintendent,65,3
Treutlen,Absentee by Mail,50,State School Superintendent,49,1
Treutlen,Advance in Person,426,State School Superintendent,426,0
Treutlen,Election Day,1041,State School Superintendent,1038,3
Treutlen,Provisional,3,State School Superintendent,3,0
Troup,Absentee by Mail,847,State School Superintendent,824,23
Troup,Advance in Person,4821,State School Superintendent,4821,0
Troup,Election Day,9963,State School Superintendent,9951,12
Troup,Provisional,41,State School Superintendent,38,3
Turner,Absentee by Mail,41,State School Superintendent,39,2
Turner,Advance in Person,1026,State School Superintendent,1026,0
Turner,Election Day,1188,State School Superintendent,1171,17
Turner,Provisional,11,State School Superintendent,11,0
Twiggs,Absentee by Mail,275,State School Superintendent,273,2
Twiggs,Advance in Person,841,State School Superintendent,841,0
Twiggs,Election Day,1776,State School Superintendent,1762,14
Twiggs,Provisional,1,State School Superintendent,1,0
Union,Absentee by Mail,288,State School Superintendent,279,9
Union,Advance in Person,3487,State School Superintendent,3427,60
Union,Election Day,3966,State School Superintendent,3873,93
Union,Provisional,2,State School Superintendent,2,0
Upson,Absentee by Mail,230,State School Superintendent,226,4
Upson,Advance in Person,2400,State School Superintendent,2380,20
Upson,Election Day,4440,State School Superintendent,4424,16
Upson,Provisional,1,State School Superintendent,1,0
Walker,Absentee by Mail,617,State School Superintendent,600,17
Walker,Advance in Person,3646,State School Superintendent,3632,14
Walker,Election Day,8076,State School Superintendent,8040,36
Walker,Provisional,0,State School Superintendent,0,0
Walton,Absentee by Mail,1068,State School Superintendent,1037,31
Walton,Advance in Person,6096,State School Superintendent,6051,45
Walton,Election Day,18659,State School Superintendent,18509,150
Walton,Provisional,16,State School Superintendent,15,1
Ware,Absentee by Mail,326,State School Superintendent,323,3
Ware,Advance in Person,2081,State School Superintendent,2081,0
Ware,Election Day,4306,State School Superintendent,4306,0
Ware,Provisional,1,State School Superintendent,1,0
Warren,Absentee by Mail,60,State School Superintendent,60,0
Warren,Advance in Person,543,State School Superintendent,543,0
Warren,Election Day,889,State School Superintendent,889,0
Warren,Provisional,1,State School Superintendent,1,0
Washington,Absentee by Mail,355,State School Superintendent,349,6
Washington,Advance in Person,2324,State School Superintendent,2316,8
Washington,Election Day,3362,State School Superintendent,3300,62
Washington,Provisional,8,State School Superintendent,8,0
Wayne,Absentee by Mail,258,State School Superintendent,251,7
Wayne,Advance in Person,2152,State School Superintendent,2147,5
Wayne,Election Day,3740,State School Superintendent,3735,5
Wayne,Provisional,0,State School Superintendent,0,0
Webster,Absentee by Mail,80,State School Superintendent,76,4
Webster,Advance in Person,271,State School Superintendent,269,2
Webster,Election Day,426,State School Superintendent,421,5
Webster,Provisional,0,State School Superintendent,0,0
Wheeler,Absentee by Mail,87,State School Superintendent,84,3
Wheeler,Advance in Person,447,State School Superintendent,433,14
Wheeler,Election Day,959,State School Superintendent,956,3
Wheeler,Provisional,9,State School Superintendent,9,0
White,Absentee by Mail,447,State School Superintendent,434,13
White,Advance in Person,2267,State School Superintendent,2236,31
White,Election Day,4948,State School Superintendent,4853,95
White,Provisional,3,State School Superintendent,3,0
Whitfield,Absentee by Mail,478,State School Superintendent,466,12
Whitfield,Advance in Person,3511,State School Superintendent,3440,71
Whitfield,Election Day,11767,State School Superintendent,11635,132
Whitfield,Provisional,38,State School Superintendent,38,0
Wilcox,Absentee by Mail,144,State School Superintendent,142,2
Wilcox,Advance in Person,455,State School Superintendent,455,0
Wilcox,Election Day,1280,State School Superintendent,1280,0
Wilcox,Provisional,3,State School Superintendent,3,0
Wilkes,Absentee by Mail,104,State School Superintendent,103,1
Wilkes,Advance in Person,939,State School Superintendent,930,9
Wilkes,Election Day,2044,State School Superintendent,2036,8
Wilkes,Provisional,3,State School Superintendent,3,0
Wilkinson,Absentee by Mail,150,State School Superintendent,148,2
Wilkinson,Advance in Person,763,State School Superintendent,756,7
Wilkinson,Election Day,2227,State School Superintendent,2219,8
Wilkinson,Provisional,1,State School Superintendent,1,0
Worth,Absentee by Mail,138,State School Superintendent,137,1
Worth,Advance in Person,1170,State School Superintendent,1166,4
Worth,Election Day,3871,State School Superintendent,3871,0
Worth,Provisional,10,State School Superintendent,10,0
Appling,Absentee by Mail,306,Commissioner Of Labor,304,2
Appling,Advance in Person,976,Commissioner Of Labor,970,6
Appling,Election Day,3122,Commissioner Of Labor,3088,34
Appling,Provisional,4,Commissioner Of Labor,4,0
Atkinson,Absentee by Mail,68,Commissioner Of Labor,64,4
Atkinson,Advance in Person,495,Commissioner Of Labor,476,19
Atkinson,Election Day,1058,Commissioner Of Labor,1007,51
Atkinson,Provisional,7,Commissioner Of Labor,6,1
Bacon,Absentee by Mail,73,Commissioner Of Labor,71,2
Bacon,Advance in Person,887,Commissioner Of Labor,873,14
Bacon,Election Day,1240,Commissioner Of Labor,1234,6
Bacon,Provisional,3,Commissioner Of Labor,3,0
Baker,Absentee by Mail,71,Commissioner Of Labor,68,3
Baker,Advance in Person,298,Commissioner Of Labor,295,3
Baker,Election Day,617,Commissioner Of Labor,597,20
Baker,Provisional,3,Commissioner Of Labor,3,0
Baldwin,Absentee by Mail,409,Commissioner Of Labor,403,6
Baldwin,Advance in Person,3933,Commissioner Of Labor,3877,56
Baldwin,Election Day,6152,Commissioner Of Labor,6126,26
Baldwin,Provisional,9,Commissioner Of Labor,9,0
Banks,Absentee by Mail,142,Commissioner Of Labor,139,3
Banks,Advance in Person,852,Commissioner Of Labor,828,24
Banks,Election Day,3339,Commissioner Of Labor,3263,76
Banks,Provisional,1,Commissioner Of Labor,1,0
Barrow,Absentee by Mail,701,Commissioner Of Labor,687,14
Barrow,Advance in Person,4720,Commissioner Of Labor,4680,40
Barrow,Election Day,10688,Commissioner Of Labor,10544,144
Barrow,Provisional,8,Commissioner Of Labor,6,2
Bartow,Absentee by Mail,772,Commissioner Of Labor,759,13
Bartow,Advance in Person,5826,Commissioner Of Labor,5790,36
Bartow,Election Day,16152,Commissioner Of Labor,15912,240
Bartow,Provisional,20,Commissioner Of Labor,20,0
Ben Hill,Absentee by Mail,136,Commissioner Of Labor,130,6
Ben Hill,Advance in Person,1494,Commissioner Of Labor,1470,24
Ben Hill,Election Day,1864,Commissioner Of Labor,1863,1
Ben Hill,Provisional,3,Commissioner Of Labor,2,1
Berrien,Absentee by Mail,212,Commissioner Of Labor,211,1
Berrien,Advance in Person,1103,Commissioner Of Labor,1097,6
Berrien,Election Day,2608,Commissioner Of Labor,2592,16
Berrien,Provisional,8,Commissioner Of Labor,8,0
Bibb,Absentee by Mail,2189,Commissioner Of Labor,2133,56
Bibb,Advance in Person,10315,Commissioner Of Labor,10234,81
Bibb,Election Day,29989,Commissioner Of Labor,29547,442
Bibb,Provisional,78,Commissioner Of Labor,78,0
Bleckley,Absentee by Mail,228,Commissioner Of Labor,218,10
Bleckley,Advance in Person,1157,Commissioner Of Labor,1140,17
Bleckley,Election Day,1855,Commissioner Of Labor,1834,21
Bleckley,Provisional,5,Commissioner Of Labor,4,1
Brantley,Absentee by Mail,143,Commissioner Of Labor,141,2
Brantley,Advance in Person,747,Commissioner Of Labor,737,10
Brantley,Election Day,2086,Commissioner Of Labor,2058,28
Brantley,Provisional,4,Commissioner Of Labor,4,0
Brooks,Absentee by Mail,1016,Commissioner Of Labor,992,24
Brooks,Advance in Person,1259,Commissioner Of Labor,1235,24
Brooks,Election Day,2355,Commissioner Of Labor,2336,19
Brooks,Provisional,26,Commissioner Of Labor,24,2
Bryan,Absentee by Mail,237,Commissioner Of Labor,232,5
Bryan,Advance in Person,2852,Commissioner Of Labor,2834,18
Bryan,Election Day,4863,Commissioner Of Labor,4818,45
Bryan,Provisional,3,Commissioner Of Labor,3,0
Bulloch,Absentee by Mail,541,Commissioner Of Labor,529,12
Bulloch,Advance in Person,3846,Commissioner Of Labor,3804,42
Bulloch,Election Day,9455,Commissioner Of Labor,9312,143
Bulloch,Provisional,12,Commissioner Of Labor,11,1
Burke,Absentee by Mail,594,Commissioner Of Labor,588,6
Burke,Advance in Person,1260,Commissioner Of Labor,1253,7
Burke,Election Day,4049,Commissioner Of Labor,4014,35
Burke,Provisional,0,Commissioner Of Labor,0,0
Butts,Absentee by Mail,183,Commissioner Of Labor,181,2
Butts,Advance in Person,3252,Commissioner Of Labor,3212,40
Butts,Election Day,2671,Commissioner Of Labor,2642,29
Butts,Provisional,0,Commissioner Of Labor,0,0
Calhoun,Absentee by Mail,91,Commissioner Of Labor,90,1
Calhoun,Advance in Person,320,Commissioner Of Labor,317,3
Calhoun,Election Day,1044,Commissioner Of Labor,1040,4
Calhoun,Provisional,2,Commissioner Of Labor,2,0
Camden,Absentee by Mail,586,Commissioner Of Labor,580,6
Camden,Advance in Person,2509,Commissioner Of Labor,2484,25
Camden,Election Day,6720,Commissioner Of Labor,6684,36
Camden,Provisional,9,Commissioner Of Labor,9,0
Candler,Absentee by Mail,108,Commissioner Of Labor,105,3
Candler,Advance in Person,835,Commissioner Of Labor,827,8
Candler,Election Day,1258,Commissioner Of Labor,1245,13
Candler,Provisional,0,Commissioner Of Labor,0,0
Carroll,Absentee by Mail,845,Commissioner Of Labor,829,16
Carroll,Advance in Person,7673,Commissioner Of Labor,7622,51
Carroll,Election Day,17495,Commissioner Of Labor,17399,96
Carroll,Provisional,53,Commissioner Of Labor,52,1
Catoosa,Absentee by Mail,456,Commissioner Of Labor,444,12
Catoosa,Advance in Person,4909,Commissioner Of Labor,4835,74
Catoosa,Election Day,8541,Commissioner Of Labor,8368,173
Catoosa,Provisional,14,Commissioner Of Labor,14,0
Charlton,Absentee by Mail,80,Commissioner Of Labor,80,0
Charlton,Advance in Person,684,Commissioner Of Labor,679,5
Charlton,Election Day,1247,Commissioner Of Labor,1231,16
Charlton,Provisional,4,Commissioner Of Labor,4,0
Chatham,Absentee by Mail,2948,Commissioner Of Labor,2853,95
Chatham,Advance in Person,17241,Commissioner Of Labor,17155,86
Chatham,Election Day,48480,Commissioner Of Labor,48044,436
Chatham,Provisional,55,Commissioner Of Labor,53,2
Chattahoochee,Absentee by Mail,22,Commissioner Of Labor,22,0
Chattahoochee,Advance in Person,196,Commissioner Of Labor,195,1
Chattahoochee,Election Day,481,Commissioner Of Labor,477,4
Chattahoochee,Provisional,2,Commissioner Of Labor,2,0
Chattooga,Absentee by Mail,107,Commissioner Of Labor,105,2
Chattooga,Advance in Person,1625,Commissioner Of Labor,1577,48
Chattooga,Election Day,3090,Commissioner Of Labor,3029,61
Chattooga,Provisional,2,Commissioner Of Labor,2,0
Cherokee,Absentee by Mail,2440,Commissioner Of Labor,2345,95
Cherokee,Advance in Person,23437,Commissioner Of Labor,22892,545
Cherokee,Election Day,40811,Commissioner Of Labor,39692,1119
Cherokee,Provisional,31,Commissioner Of Labor,29,2
Clarke,Absentee by Mail,1152,Commissioner Of Labor,1105,47
Clarke,Advance in Person,7332,Commissioner Of Labor,7171,161
Clarke,Election Day,16976,Commissioner Of Labor,16392,584
Clarke,Provisional,76,Commissioner Of Labor,72,4
Clay,Absentee by Mail,90,Commissioner Of Labor,88,2
Clay,Advance in Person,244,Commissioner Of Labor,242,2
Clay,Election Day,602,Commissioner Of Labor,597,5
Clay,Provisional,1,Commissioner Of Labor,1,0
Clayton,Absentee by Mail,1772,Commissioner Of Labor,1751,21
Clayton,Advance in Person,25878,Commissioner Of Labor,25769,109
Clayton,Election Day,34794,Commissioner Of Labor,34616,178
Clayton,Provisional,66,Commissioner Of Labor,62,4
Clinch,Absentee by Mail,53,Commissioner Of Labor,52,1
Clinch,Advance in Person,340,Commissioner Of Labor,339,1
Clinch,Election Day,777,Commissioner Of Labor,766,11
Clinch,Provisional,2,Commissioner Of Labor,1,1
Cobb,Absentee by Mail,10616,Commissioner Of Labor,10229,387
Cobb,Advance in Person,58755,Commissioner Of Labor,57520,1235
Cobb,Election Day,143123,Commissioner Of Labor,138630,4493
Cobb,Provisional,581,Commissioner Of Labor,558,23
Coffee,Absentee by Mail,328,Commissioner Of Labor,321,7
Coffee,Advance in Person,3477,Commissioner Of Labor,3455,22
Coffee,Election Day,4390,Commissioner Of Labor,4328,62
Coffee,Provisional,7,Commissioner Of Labor,7,0
Colquitt,Absentee by Mail,172,Commissioner Of Labor,168,4
Colquitt,Advance in Person,2409,Commissioner Of Labor,2385,24
Colquitt,Election Day,5359,Commissioner Of Labor,5300,59
Colquitt,Provisional,4,Commissioner Of Labor,4,0
Columbia,Absentee by Mail,1698,Commissioner Of Labor,1655,43
Columbia,Advance in Person,11710,Commissioner Of Labor,11643,67
Columbia,Election Day,26403,Commissioner Of Labor,26212,191
Columbia,Provisional,10,Commissioner Of Labor,10,0
Cook,Absentee by Mail,113,Commissioner Of Labor,113,0
Cook,Advance in Person,1115,Commissioner Of Labor,1105,10
Cook,Election Day,2316,Commissioner Of Labor,2305,11
Cook,Provisional,0,Commissioner Of Labor,0,0
Coweta,Absentee by Mail,1733,Commissioner Of Labor,1694,39
Coweta,Advance in Person,9167,Commissioner Of Labor,9055,112
Coweta,Election Day,26256,Commissioner Of Labor,25956,300
Coweta,Provisional,15,Commissioner Of Labor,15,0
Crawford,Absentee by Mail,146,Commissioner Of Labor,144,2
Crawford,Advance in Person,1092,Commissioner Of Labor,1073,19
Crawford,Election Day,2012,Commissioner Of Labor,1993,19
Crawford,Provisional,4,Commissioner Of Labor,4,0
Crisp,Absentee by Mail,169,Commissioner Of Labor,165,4
Crisp,Advance in Person,2060,Commissioner Of Labor,2028,32
Crisp,Election Day,2752,Commissioner Of Labor,2707,45
Crisp,Provisional,2,Commissioner Of Labor,2,0
Dade,Absentee by Mail,114,Commissioner Of Labor,104,10
Dade,Advance in Person,1030,Commissioner Of Labor,983,47
Dade,Election Day,2283,Commissioner Of Labor,2182,101
Dade,Provisional,9,Commissioner Of Labor,9,0
Dawson,Absentee by Mail,311,Commissioner Of Labor,300,11
Dawson,Advance in Person,3231,Commissioner Of Labor,3160,71
Dawson,Election Day,3731,Commissioner Of Labor,3633,98
Dawson,Provisional,11,Commissioner Of Labor,11,0
DeKalb,Absentee by Mail,8280,Commissioner Of Labor,7857,423
DeKalb,Advance in Person,72480,Commissioner Of Labor,71419,1061
DeKalb,Election Day,129376,Commissioner Of Labor,125361,4015
DeKalb,Provisional,503,Commissioner Of Labor,478,25
Decatur,Absentee by Mail,269,Commissioner Of Labor,265,4
Decatur,Advance in Person,1985,Commissioner Of Labor,1974,11
Decatur,Election Day,3820,Commissioner Of Labor,3785,35
Decatur,Provisional,5,Commissioner Of Labor,5,0
Dodge,Absentee by Mail,219,Commissioner Of Labor,214,5
Dodge,Advance in Person,1690,Commissioner Of Labor,1636,54
Dodge,Election Day,3173,Commissioner Of Labor,3103,70
Dodge,Provisional,0,Commissioner Of Labor,0,0
Dooly,Absentee by Mail,68,Commissioner Of Labor,66,2
Dooly,Advance in Person,834,Commissioner Of Labor,795,39
Dooly,Election Day,1783,Commissioner Of Labor,1756,27
Dooly,Provisional,0,Commissioner Of Labor,0,0
Dougherty,Absentee by Mail,1050,Commissioner Of Labor,1028,22
Dougherty,Advance in Person,6272,Commissioner Of Labor,6237,35
Dougherty,Election Day,16148,Commissioner Of Labor,16100,48
Dougherty,Provisional,41,Commissioner Of Labor,39,2
Douglas,Absentee by Mail,1308,Commissioner Of Labor,1285,23
Douglas,Advance in Person,15797,Commissioner Of Labor,15703,94
Douglas,Election Day,20398,Commissioner Of Labor,20282,116
Douglas,Provisional,27,Commissioner Of Labor,27,0
Early,Absentee by Mail,140,Commissioner Of Labor,140,0
Early,Advance in Person,890,Commissioner Of Labor,874,16
Early,Election Day,2163,Commissioner Of Labor,2146,17
Early,Provisional,3,Commissioner Of Labor,3,0
Echols,Absentee by Mail,19,Commissioner Of Labor,19,0
Echols,Advance in Person,243,Commissioner Of Labor,236,7
Echols,Election Day,361,Commissioner Of Labor,355,6
Echols,Provisional,0,Commissioner Of Labor,0,0
Effingham,Absentee by Mail,373,Commissioner Of Labor,366,7
Effingham,Advance in Person,3036,Commissioner Of Labor,3026,10
Effingham,Election Day,9204,Commissioner Of Labor,9148,56
Effingham,Provisional,10,Commissioner Of Labor,10,0
Elbert,Absentee by Mail,219,Commissioner Of Labor,215,4
Elbert,Advance in Person,1841,Commissioner Of Labor,1823,18
Elbert,Election Day,2632,Commissioner Of Labor,2615,17
Elbert,Provisional,11,Commissioner Of Labor,11,0
Emanuel,Absentee by Mail,213,Commissioner Of Labor,206,7
Emanuel,Advance in Person,1187,Commissioner Of Labor,1163,24
Emanuel,Election Day,3581,Commissioner Of Labor,3522,59
Emanuel,Provisional,1,Commissioner Of Labor,1,0
Evans,Absentee by Mail,122,Commissioner Of Labor,117,5
Evans,Advance in Person,921,Commissioner Of Labor,907,14
Evans,Election Day,1107,Commissioner Of Labor,1097,10
Evans,Provisional,0,Commissioner Of Labor,0,0
Fannin,Absentee by Mail,417,Commissioner Of Labor,407,10
Fannin,Advance in Person,2268,Commissioner Of Labor,2220,48
Fannin,Election Day,4216,Commissioner Of Labor,4104,112
Fannin,Provisional,3,Commissioner Of Labor,2,1
Fayette,Absentee by Mail,1272,Commissioner Of Labor,1227,45
Fayette,Advance in Person,18189,Commissioner Of Labor,17894,295
Fayette,Election Day,22606,Commissioner Of Labor,22076,530
Fayette,Provisional,13,Commissioner Of Labor,11,2
Floyd,Absentee by Mail,771,Commissioner Of Labor,745,26
Floyd,Advance in Person,5763,Commissioner Of Labor,5701,62
Floyd,Election Day,14210,Commissioner Of Labor,13941,269
Floyd,Provisional,78,Commissioner Of Labor,74,4
Forsyth,Absentee by Mail,1655,Commissioner Of Labor,1593,62
Forsyth,Advance in Person,22647,Commissioner Of Labor,22232,415
Forsyth,Election Day,32220,Commissioner Of Labor,31489,731
Forsyth,Provisional,48,Commissioner Of Labor,45,3
Franklin,Absentee by Mail,198,Commissioner Of Labor,191,7
Franklin,Advance in Person,1077,Commissioner Of Labor,1070,7
Franklin,Election Day,3454,Commissioner Of Labor,3436,18
Franklin,Provisional,1,Commissioner Of Labor,1,0
Fulton,Absentee by Mail,8864,Commissioner Of Labor,8486,378
Fulton,Advance in Person,87201,Commissioner Of Labor,85468,1733
Fulton,Election Day,167468,Commissioner Of Labor,162177,5291
Fulton,Provisional,2135,Commissioner Of Labor,2050,85
Gilmer,Absentee by Mail,378,Commissioner Of Labor,373,5
Gilmer,Advance in Person,2578,Commissioner Of Labor,2501,77
Gilmer,Election Day,4854,Commissioner Of Labor,4683,171
Gilmer,Provisional,16,Commissioner Of Labor,16,0
Glascock,Absentee by Mail,36,Commissioner Of Labor,32,4
Glascock,Advance in Person,211,Commissioner Of Labor,201,10
Glascock,Election Day,542,Commissioner Of Labor,536,6
Glascock,Provisional,0,Commissioner Of Labor,0,0
Glynn,Absentee by Mail,883,Commissioner Of Labor,863,20
Glynn,Advance in Person,7098,Commissioner Of Labor,7026,72
Glynn,Election Day,12102,Commissioner Of Labor,11974,128
Glynn,Provisional,36,Commissioner Of Labor,35,1
Gordon,Absentee by Mail,370,Commissioner Of Labor,353,17
Gordon,Advance in Person,2666,Commissioner Of Labor,2566,100
Gordon,Election Day,7273,Commissioner Of Labor,7044,229
Gordon,Provisional,16,Commissioner Of Labor,14,2
Grady,Absentee by Mail,157,Commissioner Of Labor,154,3
Grady,Advance in Person,1854,Commissioner Of Labor,1834,20
Grady,Election Day,3548,Commissioner Of Labor,3529,19
Grady,Provisional,6,Commissioner Of Labor,6,0
Greene,Absentee by Mail,538,Commissioner Of Labor,529,9
Greene,Advance in Person,3068,Commissioner Of Labor,3028,40
Greene,Election Day,2907,Commissioner Of Labor,2841,66
Greene,Provisional,10,Commissioner Of Labor,10,0
Gwinnett,Absentee by Mail,8170,Commissioner Of Labor,7907,263
Gwinnett,Advance in Person,47244,Commissioner Of Labor,46784,460
Gwinnett,Election Day,141636,Commissioner Of Labor,138963,2673
Gwinnett,Provisional,1155,Commissioner Of Labor,1127,28
Habersham,Absentee by Mail,704,Commissioner Of Labor,679,25
Habersham,Advance in Person,5381,Commissioner Of Labor,5243,138
Habersham,Election Day,3529,Commissioner Of Labor,3437,92
Habersham,Provisional,34,Commissioner Of Labor,30,4
Hall,Absentee by Mail,2074,Commissioner Of Labor,2014,60
Hall,Advance in Person,12299,Commissioner Of Labor,12082,217
Hall,Election Day,29428,Commissioner Of Labor,28782,646
Hall,Provisional,42,Commissioner Of Labor,42,0
Hancock,Absentee by Mail,283,Commissioner Of Labor,279,4
Hancock,Advance in Person,839,Commissioner Of Labor,819,20
Hancock,Election Day,1257,Commissioner Of Labor,1235,22
Hancock,Provisional,19,Commissioner Of Labor,17,2
Haralson,Absentee by Mail,262,Commissioner Of Labor,254,8
Haralson,Advance in Person,1563,Commissioner Of Labor,1552,11
Haralson,Election Day,4986,Commissioner Of Labor,4932,54
Haralson,Provisional,2,Commissioner Of Labor,2,0
Harris,Absentee by Mail,493,Commissioner Of Labor,486,7
Harris,Advance in Person,2950,Commissioner Of Labor,2942,8
Harris,Election Day,6803,Commissioner Of Labor,6765,38
Harris,Provisional,2,Commissioner Of Labor,2,0
Hart,Absentee by Mail,287,Commissioner Of Labor,275,12
Hart,Advance in Person,2309,Commissioner Of Labor,2236,73
Hart,Election Day,4185,Commissioner Of Labor,4120,65
Hart,Provisional,1,Commissioner Of Labor,1,0
Heard,Absentee by Mail,157,Commissioner Of Labor,155,2
Heard,Advance in Person,552,Commissioner Of Labor,544,8
Heard,Election Day,1772,Commissioner Of Labor,1756,16
Heard,Provisional,0,Commissioner Of Labor,0,0
Henry,Absentee by Mail,2016,Commissioner Of Labor,1984,32
Henry,Advance in Person,29231,Commissioner Of Labor,29123,108
Henry,Election Day,31732,Commissioner Of Labor,31499,233
Henry,Provisional,102,Commissioner Of Labor,101,1
Houston,Absentee by Mail,1431,Commissioner Of Labor,1395,36
Houston,Advance in Person,16400,Commissioner Of Labor,16283,117
Houston,Election Day,19454,Commissioner Of Labor,19248,206
Houston,Provisional,62,Commissioner Of Labor,56,6
Irwin,Absentee by Mail,61,Commissioner Of Labor,60,1
Irwin,Advance in Person,719,Commissioner Of Labor,697,22
Irwin,Election Day,1581,Commissioner Of Labor,1546,35
Irwin,Provisional,3,Commissioner Of Labor,3,0
Jackson,Absentee by Mail,495,Commissioner Of Labor,481,14
Jackson,Advance in Person,5419,Commissioner Of Labor,5388,31
Jackson,Election Day,10060,Commissioner Of Labor,9924,136
Jackson,Provisional,16,Commissioner Of Labor,14,2
Jasper,Absentee by Mail,255,Commissioner Of Labor,250,5
Jasper,Advance in Person,1280,Commissioner Of Labor,1274,6
Jasper,Election Day,2305,Commissioner Of Labor,2290,15
Jasper,Provisional,2,Commissioner Of Labor,2,0
Jeff Davis,Absentee by Mail,153,Commissioner Of Labor,147,6
Jeff Davis,Advance in Person,861,Commissioner Of Labor,840,21
Jeff Davis,Election Day,1973,Commissioner Of Labor,1943,30
Jeff Davis,Provisional,1,Commissioner Of Labor,1,0
Jefferson,Absentee by Mail,216,Commissioner Of Labor,212,4
Jefferson,Advance in Person,1158,Commissioner Of Labor,1152,6
Jefferson,Election Day,3144,Commissioner Of Labor,3120,24
Jefferson,Provisional,20,Commissioner Of Labor,20,0
Jenkins,Absentee by Mail,163,Commissioner Of Labor,160,3
Jenkins,Advance in Person,671,Commissioner Of Labor,667,4
Jenkins,Election Day,1088,Commissioner Of Labor,1079,9
Jenkins,Provisional,0,Commissioner Of Labor,0,0
Johnson,Absentee by Mail,92,Commissioner Of Labor,90,2
Johnson,Advance in Person,789,Commissioner Of Labor,781,8
Johnson,Election Day,1415,Commissioner Of Labor,1406,9
Johnson,Provisional,0,Commissioner Of Labor,0,0
Jones,Absentee by Mail,511,Commissioner Of Labor,503,8
Jones,Advance in Person,2913,Commissioner Of Labor,2902,11
Jones,Election Day,4638,Commissioner Of Labor,4612,26
Jones,Provisional,7,Commissioner Of Labor,7,0
Lamar,Absentee by Mail,215,Commissioner Of Labor,208,7
Lamar,Advance in Person,1700,Commissioner Of Labor,1679,21
Lamar,Election Day,3046,Commissioner Of Labor,3031,15
Lamar,Provisional,5,Commissioner Of Labor,5,0
Lanier,Absentee by Mail,40,Commissioner Of Labor,40,0
Lanier,Advance in Person,521,Commissioner Of Labor,512,9
Lanier,Election Day,878,Commissioner Of Labor,871,7
Lanier,Provisional,4,Commissioner Of Labor,4,0
Laurens,Absentee by Mail,763,Commissioner Of Labor,753,10
Laurens,Advance in Person,3953,Commissioner Of Labor,3945,8
Laurens,Election Day,8153,Commissioner Of Labor,8066,87
Laurens,Provisional,14,Commissioner Of Labor,13,1
Lee,Absentee by Mail,241,Commissioner Of Labor,234,7
Lee,Advance in Person,2107,Commissioner Of Labor,2097,10
Lee,Election Day,6514,Commissioner Of Labor,6477,37
Lee,Provisional,5,Commissioner Of Labor,5,0
Liberty,Absentee by Mail,209,Commissioner Of Labor,204,5
Liberty,Advance in Person,3652,Commissioner Of Labor,3631,21
Liberty,Election Day,5097,Commissioner Of Labor,5065,32
Liberty,Provisional,4,Commissioner Of Labor,4,0
Lincoln,Absentee by Mail,222,Commissioner Of Labor,220,2
Lincoln,Advance in Person,899,Commissioner Of Labor,896,3
Lincoln,Election Day,1554,Commissioner Of Labor,1536,18
Lincoln,Provisional,13,Commissioner Of Labor,13,0
Long,Absentee by Mail,40,Commissioner Of Labor,40,0
Long,Advance in Person,691,Commissioner Of Labor,688,3
Long,Election Day,1397,Commissioner Of Labor,1375,22
Long,Provisional,6,Commissioner Of Labor,6,0
Lowndes,Absentee by Mail,532,Commissioner Of Labor,518,14
Lowndes,Advance in Person,8813,Commissioner Of Labor,8808,5
Lowndes,Election Day,11478,Commissioner Of Labor,11422,56
Lowndes,Provisional,560,Commissioner Of Labor,554,6
Lumpkin,Absentee by Mail,305,Commissioner Of Labor,297,8
Lumpkin,Advance in Person,2933,Commissioner Of Labor,2886,47
Lumpkin,Election Day,4404,Commissioner Of Labor,4302,102
Lumpkin,Provisional,15,Commissioner Of Labor,14,1
Macon,Absentee by Mail,106,Commissioner Of Labor,106,0
Macon,Advance in Person,1207,Commissioner Of Labor,1156,51
Macon,Election Day,1695,Commissioner Of Labor,1650,45
Macon,Provisional,0,Commissioner Of Labor,0,0
Madison,Absentee by Mail,312,Commissioner Of Labor,297,15
Madison,Advance in Person,2257,Commissioner Of Labor,2220,37
Madison,Election Day,4970,Commissioner Of Labor,4854,116
Madison,Provisional,6,Commissioner Of Labor,6,0
Marion,Absentee by Mail,219,Commissioner Of Labor,214,5
Marion,Advance in Person,612,Commissioner Of Labor,602,10
Marion,Election Day,1314,Commissioner Of Labor,1290,24
Marion,Provisional,0,Commissioner Of Labor,0,0
McDuffie,Absentee by Mail,351,Commissioner Of Labor,344,7
McDuffie,Advance in Person,2043,Commissioner Of Labor,2026,17
McDuffie,Election Day,3653,Commissioner Of Labor,3631,22
McDuffie,Provisional,3,Commissioner Of Labor,3,0
McIntosh,Absentee by Mail,300,Commissioner Of Labor,287,13
McIntosh,Advance in Person,1300,Commissioner Of Labor,1287,13
McIntosh,Election Day,2233,Commissioner Of Labor,2201,32
McIntosh,Provisional,7,Commissioner Of Labor,6,1
Meriwether,Absentee by Mail,207,Commissioner Of Labor,201,6
Meriwether,Advance in Person,1188,Commissioner Of Labor,1179,9
Meriwether,Election Day,4671,Commissioner Of Labor,4600,71
Meriwether,Provisional,1,Commissioner Of Labor,1,0
Miller,Absentee by Mail,53,Commissioner Of Labor,49,4
Miller,Advance in Person,436,Commissioner Of Labor,425,11
Miller,Election Day,937,Commissioner Of Labor,925,12
Miller,Provisional,1,Commissioner Of Labor,1,0
Mitchell,Absentee by Mail,202,Commissioner Of Labor,197,5
Mitchell,Advance in Person,1589,Commissioner Of Labor,1572,17
Mitchell,Election Day,3215,Commissioner Of Labor,3194,21
Mitchell,Provisional,3,Commissioner Of Labor,3,0
Monroe,Absentee by Mail,358,Commissioner Of Labor,353,5
Monroe,Advance in Person,2523,Commissioner Of Labor,2491,32
Monroe,Election Day,5671,Commissioner Of Labor,5602,69
Monroe,Provisional,23,Commissioner Of Labor,22,1
Montgomery,Absentee by Mail,92,Commissioner Of Labor,88,4
Montgomery,Advance in Person,463,Commissioner Of Labor,450,13
Montgomery,Election Day,1730,Commissioner Of Labor,1704,26
Montgomery,Provisional,0,Commissioner Of Labor,0,0
Morgan,Absentee by Mail,193,Commissioner Of Labor,188,5
Morgan,Advance in Person,2475,Commissioner Of Labor,2446,29
Morgan,Election Day,3635,Commissioner Of Labor,3577,58
Morgan,Provisional,7,Commissioner Of Labor,6,1
Murray,Absentee by Mail,207,Commissioner Of Labor,191,16
Murray,Advance in Person,1347,Commissioner Of Labor,1309,38
Murray,Election Day,4497,Commissioner Of Labor,4388,109
Murray,Provisional,0,Commissioner Of Labor,0,0
Muscogee,Absentee by Mail,2150,Commissioner Of Labor,2104,46
Muscogee,Advance in Person,13494,Commissioner Of Labor,13400,94
Muscogee,Election Day,25301,Commissioner Of Labor,25171,130
Muscogee,Provisional,63,Commissioner Of Labor,63,0
Newton,Absentee by Mail,1136,Commissioner Of Labor,1114,22
Newton,Advance in Person,10430,Commissioner Of Labor,10398,32
Newton,Election Day,16634,Commissioner Of Labor,16542,92
Newton,Provisional,2,Commissioner Of Labor,2,0
Oconee,Absentee by Mail,368,Commissioner Of Labor,350,18
Oconee,Advance in Person,5438,Commissioner Of Labor,5279,159
Oconee,Election Day,7726,Commissioner Of Labor,7391,335
Oconee,Provisional,7,Commissioner Of Labor,7,0
Oglethorpe,Absentee by Mail,217,Commissioner Of Labor,212,5
Oglethorpe,Advance in Person,1609,Commissioner Of Labor,1590,19
Oglethorpe,Election Day,2262,Commissioner Of Labor,2228,34
Oglethorpe,Provisional,4,Commissioner Of Labor,4,0
Paulding,Absentee by Mail,1789,Commissioner Of Labor,1749,40
Paulding,Advance in Person,14824,Commissioner Of Labor,14740,84
Paulding,Election Day,19620,Commissioner Of Labor,19457,163
Paulding,Provisional,29,Commissioner Of Labor,26,3
Peach,Absentee by Mail,215,Commissioner Of Labor,211,4
Peach,Advance in Person,3402,Commissioner Of Labor,3374,28
Peach,Election Day,3620,Commissioner Of Labor,3606,14
Peach,Provisional,8,Commissioner Of Labor,8,0
Pickens,Absentee by Mail,138,Commissioner Of Labor,135,3
Pickens,Advance in Person,3653,Commissioner Of Labor,3568,85
Pickens,Election Day,5031,Commissioner Of Labor,4938,93
Pickens,Provisional,1,Commissioner Of Labor,1,0
Pierce,Absentee by Mail,228,Commissioner Of Labor,225,3
Pierce,Advance in Person,1629,Commissioner Of Labor,1608,21
Pierce,Election Day,2106,Commissioner Of Labor,2101,5
Pierce,Provisional,0,Commissioner Of Labor,0,0
Pike,Absentee by Mail,246,Commissioner Of Labor,236,10
Pike,Advance in Person,1650,Commissioner Of Labor,1627,23
Pike,Election Day,3700,Commissioner Of Labor,3656,44
Pike,Provisional,8,Commissioner Of Labor,8,0
Polk,Absentee by Mail,235,Commissioner Of Labor,229,6
Polk,Advance in Person,3214,Commissioner Of Labor,3175,39
Polk,Election Day,4537,Commissioner Of Labor,4468,69
Polk,Provisional,4,Commissioner Of Labor,4,0
Pulaski,Absentee by Mail,86,Commissioner Of Labor,83,3
Pulaski,Advance in Person,1249,Commissioner Of Labor,1217,32
Pulaski,Election Day,1013,Commissioner Of Labor,983,30
Pulaski,Provisional,2,Commissioner Of Labor,2,0
Putnam,Absentee by Mail,387,Commissioner Of Labor,384,3
Putnam,Advance in Person,2434,Commissioner Of Labor,2409,25
Putnam,Election Day,3451,Commissioner Of Labor,3410,41
Putnam,Provisional,2,Commissioner Of Labor,2,0
Quitman,Absentee by Mail,41,Commissioner Of Labor,41,0
Quitman,Advance in Person,209,Commissioner Of Labor,204,5
Quitman,Election Day,347,Commissioner Of Labor,344,3
Quitman,Provisional,1,Commissioner Of Labor,1,0
Rabun,Absentee by Mail,427,Commissioner Of Labor,405,22
Rabun,Advance in Person,3295,Commissioner Of Labor,3155,140
Rabun,Election Day,1731,Commissioner Of Labor,1633,98
Rabun,Provisional,0,Commissioner Of Labor,0,0
Randolph,Absentee by Mail,149,Commissioner Of Labor,146,3
Randolph,Advance in Person,789,Commissioner Of Labor,773,16
Randolph,Election Day,1173,Commissioner Of Labor,1161,12
Randolph,Provisional,7,Commissioner Of Labor,7,0
Richmond,Absentee by Mail,3207,Commissioner Of Labor,3167,40
Richmond,Advance in Person,13314,Commissioner Of Labor,13233,81
Richmond,Election Day,31248,Commissioner Of Labor,30995,253
Richmond,Provisional,71,Commissioner Of Labor,71,0
Rockdale,Absentee by Mail,825,Commissioner Of Labor,812,13
Rockdale,Advance in Person,13442,Commissioner Of Labor,13337,105
Rockdale,Election Day,12256,Commissioner Of Labor,12158,98
Rockdale,Provisional,48,Commissioner Of Labor,48,0
Schley,Absentee by Mail,66,Commissioner Of Labor,63,3
Schley,Advance in Person,602,Commissioner Of Labor,594,8
Schley,Election Day,595,Commissioner Of Labor,582,13
Schley,Provisional,3,Commissioner Of Labor,3,0
Screven,Absentee by Mail,158,Commissioner Of Labor,153,5
Screven,Advance in Person,1201,Commissioner Of Labor,1184,17
Screven,Election Day,2412,Commissioner Of Labor,2401,11
Screven,Provisional,4,Commissioner Of Labor,4,0
Seminole,Absentee by Mail,76,Commissioner Of Labor,73,3
Seminole,Advance in Person,477,Commissioner Of Labor,477,0
Seminole,Election Day,1698,Commissioner Of Labor,1678,20
Seminole,Provisional,5,Commissioner Of Labor,5,0
Spalding,Absentee by Mail,528,Commissioner Of Labor,506,22
Spalding,Advance in Person,6771,Commissioner Of Labor,6684,87
Spalding,Election Day,9378,Commissioner Of Labor,9273,105
Spalding,Provisional,14,Commissioner Of Labor,14,0
Stephens,Absentee by Mail,337,Commissioner Of Labor,327,10
Stephens,Advance in Person,2604,Commissioner Of Labor,2579,25
Stephens,Election Day,2225,Commissioner Of Labor,2197,28
Stephens,Provisional,2,Commissioner Of Labor,2,0
Stewart,Absentee by Mail,75,Commissioner Of Labor,72,3
Stewart,Advance in Person,311,Commissioner Of Labor,282,29
Stewart,Election Day,808,Commissioner Of Labor,768,40
Stewart,Provisional,18,Commissioner Of Labor,18,0
Sumter,Absentee by Mail,522,Commissioner Of Labor,516,6
Sumter,Advance in Person,3280,Commissioner Of Labor,3250,30
Sumter,Election Day,4191,Commissioner Of Labor,4137,54
Sumter,Provisional,5,Commissioner Of Labor,5,0
Talbot,Absentee by Mail,215,Commissioner Of Labor,203,12
Talbot,Advance in Person,342,Commissioner Of Labor,341,1
Talbot,Election Day,1588,Commissioner Of Labor,1566,22
Talbot,Provisional,2,Commissioner Of Labor,1,1
Taliaferro,Absentee by Mail,50,Commissioner Of Labor,50,0
Taliaferro,Advance in Person,197,Commissioner Of Labor,192,5
Taliaferro,Election Day,311,Commissioner Of Labor,310,1
Taliaferro,Provisional,0,Commissioner Of Labor,0,0
Tattnall,Absentee by Mail,198,Commissioner Of Labor,194,4
Tattnall,Advance in Person,1310,Commissioner Of Labor,1278,32
Tattnall,Election Day,2706,Commissioner Of Labor,2665,41
Tattnall,Provisional,6,Commissioner Of Labor,6,0
Taylor,Absentee by Mail,127,Commissioner Of Labor,126,1
Taylor,Advance in Person,620,Commissioner Of Labor,611,9
Taylor,Election Day,1441,Commissioner Of Labor,1434,7
Taylor,Provisional,0,Commissioner Of Labor,0,0
Telfair,Absentee by Mail,227,Commissioner Of Labor,225,2
Telfair,Advance in Person,751,Commissioner Of Labor,729,22
Telfair,Election Day,1723,Commissioner Of Labor,1703,20
Telfair,Provisional,0,Commissioner Of Labor,0,0
Terrell,Absentee by Mail,258,Commissioner Of Labor,238,20
Terrell,Advance in Person,1101,Commissioner Of Labor,1069,32
Terrell,Election Day,1887,Commissioner Of Labor,1859,28
Terrell,Provisional,2,Commissioner Of Labor,2,0
Thomas,Absentee by Mail,293,Commissioner Of Labor,287,6
Thomas,Advance in Person,3653,Commissioner Of Labor,3643,10
Thomas,Election Day,7055,Commissioner Of Labor,7034,21
Thomas,Provisional,2,Commissioner Of Labor,2,0
Tift,Absentee by Mail,254,Commissioner Of Labor,249,5
Tift,Advance in Person,3128,Commissioner Of Labor,3100,28
Tift,Election Day,5030,Commissioner Of Labor,4945,85
Tift,Provisional,92,Commissioner Of Labor,90,2
Toombs,Absentee by Mail,381,Commissioner Of Labor,375,6
Toombs,Advance in Person,1805,Commissioner Of Labor,1784,21
Toombs,Election Day,3352,Commissioner Of Labor,3328,24
Toombs,Provisional,6,Commissioner Of Labor,6,0
Towns,Absentee by Mail,190,Commissioner Of Labor,183,7
Towns,Advance in Person,2289,Commissioner Of Labor,2234,55
Towns,Election Day,1717,Commissioner Of Labor,1671,46
Towns,Provisional,68,Commissioner Of Labor,61,7
Treutlen,Absentee by Mail,50,Commissioner Of Labor,48,2
Treutlen,Advance in Person,426,Commissioner Of Labor,419,7
Treutlen,Election Day,1041,Commissioner Of Labor,1029,12
Treutlen,Provisional,3,Commissioner Of Labor,3,0
Troup,Absentee by Mail,847,Commissioner Of Labor,827,20
Troup,Advance in Person,4821,Commissioner Of Labor,4803,18
Troup,Election Day,9963,Commissioner Of Labor,9888,75
Troup,Provisional,41,Commissioner Of Labor,39,2
Turner,Absentee by Mail,41,Commissioner Of Labor,39,2
Turner,Advance in Person,1026,Commissioner Of Labor,1022,4
Turner,Election Day,1188,Commissioner Of Labor,1168,20
Turner,Provisional,11,Commissioner Of Labor,11,0
Twiggs,Absentee by Mail,275,Commissioner Of Labor,273,2
Twiggs,Advance in Person,841,Commissioner Of Labor,830,11
Twiggs,Election Day,1776,Commissioner Of Labor,1751,25
Twiggs,Provisional,1,Commissioner Of Labor,1,0
Union,Absentee by Mail,288,Commissioner Of Labor,278,10
Union,Advance in Person,3487,Commissioner Of Labor,3424,63
Union,Election Day,3966,Commissioner Of Labor,3861,105
Union,Provisional,2,Commissioner Of Labor,2,0
Upson,Absentee by Mail,230,Commissioner Of Labor,222,8
Upson,Advance in Person,2400,Commissioner Of Labor,2364,36
Upson,Election Day,4440,Commissioner Of Labor,4393,47
Upson,Provisional,1,Commissioner Of Labor,1,0
Walker,Absentee by Mail,617,Commissioner Of Labor,598,19
Walker,Advance in Person,3646,Commissioner Of Labor,3613,33
Walker,Election Day,8076,Commissioner Of Labor,7973,103
Walker,Provisional,0,Commissioner Of Labor,0,0
Walton,Absentee by Mail,1068,Commissioner Of Labor,1039,29
Walton,Advance in Person,6096,Commissioner Of Labor,6029,67
Walton,Election Day,18659,Commissioner Of Labor,18418,241
Walton,Provisional,16,Commissioner Of Labor,15,1
Ware,Absentee by Mail,326,Commissioner Of Labor,320,6
Ware,Advance in Person,2081,Commissioner Of Labor,2068,13
Ware,Election Day,4306,Commissioner Of Labor,4279,27
Ware,Provisional,1,Commissioner Of Labor,1,0
Warren,Absentee by Mail,60,Commissioner Of Labor,58,2
Warren,Advance in Person,543,Commissioner Of Labor,534,9
Warren,Election Day,889,Commissioner Of Labor,879,10
Warren,Provisional,1,Commissioner Of Labor,1,0
Washington,Absentee by Mail,355,Commissioner Of Labor,339,16
Washington,Advance in Person,2324,Commissioner Of Labor,2274,50
Washington,Election Day,3362,Commissioner Of Labor,3252,110
Washington,Provisional,8,Commissioner Of Labor,8,0
Wayne,Absentee by Mail,258,Commissioner Of Labor,249,9
Wayne,Advance in Person,2152,Commissioner Of Labor,2125,27
Wayne,Election Day,3740,Commissioner Of Labor,3693,47
Wayne,Provisional,0,Commissioner Of Labor,0,0
Webster,Absentee by Mail,80,Commissioner Of Labor,74,6
Webster,Advance in Person,271,Commissioner Of Labor,259,12
Webster,Election Day,426,Commissioner Of Labor,416,10
Webster,Provisional,0,Commissioner Of Labor,0,0
Wheeler,Absentee by Mail,87,Commissioner Of Labor,84,3
Wheeler,Advance in Person,447,Commissioner Of Labor,432,15
Wheeler,Election Day,959,Commissioner Of Labor,946,13
Wheeler,Provisional,9,Commissioner Of Labor,9,0
White,Absentee by Mail,447,Commissioner Of Labor,431,16
White,Advance in Person,2267,Commissioner Of Labor,2233,34
White,Election Day,4948,Commissioner Of Labor,4822,126
White,Provisional,3,Commissioner Of Labor,3,0
Whitfield,Absentee by Mail,478,Commissioner Of Labor,465,13
Whitfield,Advance in Person,3511,Commissioner Of Labor,3439,72
Whitfield,Election Day,11767,Commissioner Of Labor,11529,238
Whitfield,Provisional,38,Commissioner Of Labor,38,0
Wilcox,Absentee by Mail,144,Commissioner Of Labor,141,3
Wilcox,Advance in Person,455,Commissioner Of Labor,450,5
Wilcox,Election Day,1280,Commissioner Of Labor,1274,6
Wilcox,Provisional,3,Commissioner Of Labor,3,0
Wilkes,Absentee by Mail,104,Commissioner Of Labor,100,4
Wilkes,Advance in Person,939,Commissioner Of Labor,933,6
Wilkes,Election Day,2044,Commissioner Of Labor,2023,21
Wilkes,Provisional,3,Commissioner Of Labor,3,0
Wilkinson,Absentee by Mail,150,Commissioner Of Labor,148,2
Wilkinson,Advance in Person,763,Commissioner Of Labor,753,10
Wilkinson,Election Day,2227,Commissioner Of Labor,2189,38
Wilkinson,Provisional,1,Commissioner Of Labor,1,0
Worth,Absentee by Mail,138,Commissioner Of Labor,137,1
Worth,Advance in Person,1170,Commissioner Of Labor,1161,9
Worth,Election Day,3871,Commissioner Of Labor,3850,21
Worth,Provisional,10,Commissioner Of Labor,10,0
Appling,Absentee by Mail,306,"Public Service Commission, District 1 - Southern",269,37
Appling,Advance in Person,976,"Public Service Commission, District 1 - Southern",865,111
Appling,Election Day,3122,"Public Service Commission, District 1 - Southern",2870,252
Appling,Provisional,4,"Public Service Commission, District 1 - Southern",4,0
Atkinson,Absentee by Mail,68,"Public Service Commission, District 1 - Southern",58,10
Atkinson,Advance in Person,495,"Public Service Commission, District 1 - Southern",420,75
Atkinson,Election Day,1058,"Public Service Commission, District 1 - Southern",924,134
Atkinson,Provisional,7,"Public Service Commission, District 1 - Southern",5,2
Bacon,Absentee by Mail,73,"Public Service Commission, District 1 - Southern",67,6
Bacon,Advance in Person,887,"Public Service Commission, District 1 - Southern",832,55
Bacon,Election Day,1240,"Public Service Commission, District 1 - Southern",1179,61
Bacon,Provisional,3,"Public Service Commission, District 1 - Southern",3,0
Baker,Absentee by Mail,71,"Public Service Commission, District 1 - Southern",54,17
Baker,Advance in Person,298,"Public Service Commission, District 1 - Southern",243,55
Baker,Election Day,617,"Public Service Commission, District 1 - Southern",525,92
Baker,Provisional,3,"Public Service Commission, District 1 - Southern",2,1
Baldwin,Absentee by Mail,409,"Public Service Commission, District 1 - Southern",346,63
Baldwin,Advance in Person,3933,"Public Service Commission, District 1 - Southern",3275,658
Baldwin,Election Day,6152,"Public Service Commission, District 1 - Southern",5270,882
Baldwin,Provisional,9,"Public Service Commission, District 1 - Southern",7,2
Banks,Absentee by Mail,142,"Public Service Commission, District 1 - Southern",129,13
Banks,Advance in Person,852,"Public Service Commission, District 1 - Southern",806,46
Banks,Election Day,3339,"Public Service Commission, District 1 - Southern",3205,134
Banks,Provisional,1,"Public Service Commission, District 1 - Southern",0,1
Barrow,Absentee by Mail,701,"Public Service Commission, District 1 - Southern",643,58
Barrow,Advance in Person,4720,"Public Service Commission, District 1 - Southern",4369,351
Barrow,Election Day,10688,"Public Service Commission, District 1 - Southern",10113,575
Barrow,Provisional,8,"Public Service Commission, District 1 - Southern",5,3
Bartow,Absentee by Mail,772,"Public Service Commission, District 1 - Southern",711,61
Bartow,Advance in Person,5826,"Public Service Commission, District 1 - Southern",5374,452
Bartow,Election Day,16152,"Public Service Commission, District 1 - Southern",15305,847
Bartow,Provisional,20,"Public Service Commission, District 1 - Southern",19,1
Ben Hill,Absentee by Mail,136,"Public Service Commission, District 1 - Southern",112,24
Ben Hill,Advance in Person,1494,"Public Service Commission, District 1 - Southern",1292,202
Ben Hill,Election Day,1864,"Public Service Commission, District 1 - Southern",1663,201
Ben Hill,Provisional,3,"Public Service Commission, District 1 - Southern",1,2
Berrien,Absentee by Mail,212,"Public Service Commission, District 1 - Southern",193,19
Berrien,Advance in Person,1103,"Public Service Commission, District 1 - Southern",1021,82
Berrien,Election Day,2608,"Public Service Commission, District 1 - Southern",2498,110
Berrien,Provisional,8,"Public Service Commission, District 1 - Southern",8,0
Bibb,Absentee by Mail,2189,"Public Service Commission, District 1 - Southern",1748,441
Bibb,Advance in Person,10315,"Public Service Commission, District 1 - Southern",7698,2617
Bibb,Election Day,29989,"Public Service Commission, District 1 - Southern",25335,4654
Bibb,Provisional,78,"Public Service Commission, District 1 - Southern",67,11
Bleckley,Absentee by Mail,228,"Public Service Commission, District 1 - Southern",128,100
Bleckley,Advance in Person,1157,"Public Service Commission, District 1 - Southern",1035,122
Bleckley,Election Day,1855,"Public Service Commission, District 1 - Southern",1720,135
Bleckley,Provisional,5,"Public Service Commission, District 1 - Southern",3,2
Brantley,Absentee by Mail,143,"Public Service Commission, District 1 - Southern",134,9
Brantley,Advance in Person,747,"Public Service Commission, District 1 - Southern",706,41
Brantley,Election Day,2086,"Public Service Commission, District 1 - Southern",2003,83
Brantley,Provisional,4,"Public Service Commission, District 1 - Southern",4,0
Brooks,Absentee by Mail,1016,"Public Service Commission, District 1 - Southern",602,414
Brooks,Advance in Person,1259,"Public Service Commission, District 1 - Southern",1134,125
Brooks,Election Day,2355,"Public Service Commission, District 1 - Southern",2054,301
Brooks,Provisional,26,"Public Service Commission, District 1 - Southern",19,7
Bryan,Absentee by Mail,237,"Public Service Commission, District 1 - Southern",200,37
Bryan,Advance in Person,2852,"Public Service Commission, District 1 - Southern",2668,184
Bryan,Election Day,4863,"Public Service Commission, District 1 - Southern",4553,310
Bryan,Provisional,3,"Public Service Commission, District 1 - Southern",3,0
Bulloch,Absentee by Mail,541,"Public Service Commission, District 1 - Southern",477,64
Bulloch,Advance in Person,3846,"Public Service Commission, District 1 - Southern",3417,429
Bulloch,Election Day,9455,"Public Service Commission, District 1 - Southern",8614,841
Bulloch,Provisional,12,"Public Service Commission, District 1 - Southern",11,1
Burke,Absentee by Mail,594,"Public Service Commission, District 1 - Southern",450,144
Burke,Advance in Person,1260,"Public Service Commission, District 1 - Southern",1042,218
Burke,Election Day,4049,"Public Service Commission, District 1 - Southern",3400,649
Burke,Provisional,0,"Public Service Commission, District 1 - Southern",0,0
Butts,Absentee by Mail,183,"Public Service Commission, District 1 - Southern",168,15
Butts,Advance in Person,3252,"Public Service Commission, District 1 - Southern",2916,336
Butts,Election Day,2671,"Public Service Commission, District 1 - Southern",2456,215
Butts,Provisional,0,"Public Service Commission, District 1 - Southern",0,0
Calhoun,Absentee by Mail,91,"Public Service Commission, District 1 - Southern",76,15
Calhoun,Advance in Person,320,"Public Service Commission, District 1 - Southern",274,46
Calhoun,Election Day,1044,"Public Service Commission, District 1 - Southern",875,169
Calhoun,Provisional,2,"Public Service Commission, District 1 - Southern",2,0
Camden,Absentee by Mail,586,"Public Service Commission, District 1 - Southern",532,54
Camden,Advance in Person,2509,"Public Service Commission, District 1 - Southern",2201,308
Camden,Election Day,6720,"Public Service Commission, District 1 - Southern",6158,562
Camden,Provisional,9,"Public Service Commission, District 1 - Southern",9,0
Candler,Absentee by Mail,108,"Public Service Commission, District 1 - Southern",103,5
Candler,Advance in Person,835,"Public Service Commission, District 1 - Southern",760,75
Candler,Election Day,1258,"Public Service Commission, District 1 - Southern",1144,114
Candler,Provisional,0,"Public Service Commission, District 1 - Southern",0,0
Carroll,Absentee by Mail,845,"Public Service Commission, District 1 - Southern",787,58
Carroll,Advance in Person,7673,"Public Service Commission, District 1 - Southern",6940,733
Carroll,Election Day,17495,"Public Service Commission, District 1 - Southern",16423,1072
Carroll,Provisional,53,"Public Service Commission, District 1 - Southern",50,3
Catoosa,Absentee by Mail,456,"Public Service Commission, District 1 - Southern",427,29
Catoosa,Advance in Person,4909,"Public Service Commission, District 1 - Southern",4587,322
Catoosa,Election Day,8541,"Public Service Commission, District 1 - Southern",8117,424
Catoosa,Provisional,14,"Public Service Commission, District 1 - Southern",13,1
Charlton,Absentee by Mail,80,"Public Service Commission, District 1 - Southern",70,10
Charlton,Advance in Person,684,"Public Service Commission, District 1 - Southern",621,63
Charlton,Election Day,1247,"Public Service Commission, District 1 - Southern",1132,115
Charlton,Provisional,4,"Public Service Commission, District 1 - Southern",4,0
Chatham,Absentee by Mail,2948,"Public Service Commission, District 1 - Southern",2358,590
Chatham,Advance in Person,17241,"Public Service Commission, District 1 - Southern",14176,3065
Chatham,Election Day,48480,"Public Service Commission, District 1 - Southern",41763,6717
Chatham,Provisional,55,"Public Service Commission, District 1 - Southern",48,7
Chattahoochee,Absentee by Mail,22,"Public Service Commission, District 1 - Southern",16,6
Chattahoochee,Advance in Person,196,"Public Service Commission, District 1 - Southern",169,27
Chattahoochee,Election Day,481,"Public Service Commission, District 1 - Southern",431,50
Chattahoochee,Provisional,2,"Public Service Commission, District 1 - Southern",1,1
Chattooga,Absentee by Mail,107,"Public Service Commission, District 1 - Southern",95,12
Chattooga,Advance in Person,1625,"Public Service Commission, District 1 - Southern",1471,154
Chattooga,Election Day,3090,"Public Service Commission, District 1 - Southern",2885,205
Chattooga,Provisional,2,"Public Service Commission, District 1 - Southern",2,0
Cherokee,Absentee by Mail,2440,"Public Service Commission, District 1 - Southern",2256,184
Cherokee,Advance in Person,23437,"Public Service Commission, District 1 - Southern",21725,1712
Cherokee,Election Day,40811,"Public Service Commission, District 1 - Southern",38345,2466
Cherokee,Provisional,31,"Public Service Commission, District 1 - Southern",26,5
Clarke,Absentee by Mail,1152,"Public Service Commission, District 1 - Southern",950,202
Clarke,Advance in Person,7332,"Public Service Commission, District 1 - Southern",5490,1842
Clarke,Election Day,16976,"Public Service Commission, District 1 - Southern",13711,3265
Clarke,Provisional,76,"Public Service Commission, District 1 - Southern",58,18
Clay,Absentee by Mail,90,"Public Service Commission, District 1 - Southern",61,29
Clay,Advance in Person,244,"Public Service Commission, District 1 - Southern",211,33
Clay,Election Day,602,"Public Service Commission, District 1 - Southern",512,90
Clay,Provisional,1,"Public Service Commission, District 1 - Southern",1,0
Clayton,Absentee by Mail,1772,"Public Service Commission, District 1 - Southern",1493,279
Clayton,Advance in Person,25878,"Public Service Commission, District 1 - Southern",21203,4675
Clayton,Election Day,34794,"Public Service Commission, District 1 - Southern",29431,5363
Clayton,Provisional,66,"Public Service Commission, District 1 - Southern",49,17
Clinch,Absentee by Mail,53,"Public Service Commission, District 1 - Southern",43,10
Clinch,Advance in Person,340,"Public Service Commission, District 1 - Southern",316,24
Clinch,Election Day,777,"Public Service Commission, District 1 - Southern",702,75
Clinch,Provisional,2,"Public Service Commission, District 1 - Southern",2,0
Cobb,Absentee by Mail,10616,"Public Service Commission, District 1 - Southern",9384,1232
Cobb,Advance in Person,58755,"Public Service Commission, District 1 - Southern",51277,7478
Cobb,Election Day,143123,"Public Service Commission, District 1 - Southern",127225,15898
Cobb,Provisional,581,"Public Service Commission, District 1 - Southern",490,91
Coffee,Absentee by Mail,328,"Public Service Commission, District 1 - Southern",262,66
Coffee,Advance in Person,3477,"Public Service Commission, District 1 - Southern",3126,351
Coffee,Election Day,4390,"Public Service Commission, District 1 - Southern",3848,542
Coffee,Provisional,7,"Public Service Commission, District 1 - Southern",6,1
Colquitt,Absentee by Mail,172,"Public Service Commission, District 1 - Southern",157,15
Colquitt,Advance in Person,2409,"Public Service Commission, District 1 - Southern",2165,244
Colquitt,Election Day,5359,"Public Service Commission, District 1 - Southern",4966,393
Colquitt,Provisional,4,"Public Service Commission, District 1 - Southern",4,0
Columbia,Absentee by Mail,1698,"Public Service Commission, District 1 - Southern",1524,174
Columbia,Advance in Person,11710,"Public Service Commission, District 1 - Southern",10905,805
Columbia,Election Day,26403,"Public Service Commission, District 1 - Southern",24972,1431
Columbia,Provisional,10,"Public Service Commission, District 1 - Southern",10,0
Cook,Absentee by Mail,113,"Public Service Commission, District 1 - Southern",109,4
Cook,Advance in Person,1115,"Public Service Commission, District 1 - Southern",999,116
Cook,Election Day,2316,"Public Service Commission, District 1 - Southern",2109,207
Cook,Provisional,0,"Public Service Commission, District 1 - Southern",0,0
Coweta,Absentee by Mail,1733,"Public Service Commission, District 1 - Southern",1577,156
Coweta,Advance in Person,9167,"Public Service Commission, District 1 - Southern",8276,891
Coweta,Election Day,26256,"Public Service Commission, District 1 - Southern",24538,1718
Coweta,Provisional,15,"Public Service Commission, District 1 - Southern",13,2
Crawford,Absentee by Mail,146,"Public Service Commission, District 1 - Southern",129,17
Crawford,Advance in Person,1092,"Public Service Commission, District 1 - Southern",957,135
Crawford,Election Day,2012,"Public Service Commission, District 1 - Southern",1842,170
Crawford,Provisional,4,"Public Service Commission, District 1 - Southern",4,0
Crisp,Absentee by Mail,169,"Public Service Commission, District 1 - Southern",154,15
Crisp,Advance in Person,2060,"Public Service Commission, District 1 - Southern",1863,197
Crisp,Election Day,2752,"Public Service Commission, District 1 - Southern",2432,320
Crisp,Provisional,2,"Public Service Commission, District 1 - Southern",2,0
Dade,Absentee by Mail,114,"Public Service Commission, District 1 - Southern",101,13
Dade,Advance in Person,1030,"Public Service Commission, District 1 - Southern",919,111
Dade,Election Day,2283,"Public Service Commission, District 1 - Southern",2089,194
Dade,Provisional,9,"Public Service Commission, District 1 - Southern",8,1
Dawson,Absentee by Mail,311,"Public Service Commission, District 1 - Southern",295,16
Dawson,Advance in Person,3231,"Public Service Commission, District 1 - Southern",3066,165
Dawson,Election Day,3731,"Public Service Commission, District 1 - Southern",3567,164
Dawson,Provisional,11,"Public Service Commission, District 1 - Southern",10,1
DeKalb,Absentee by Mail,8280,"Public Service Commission, District 1 - Southern",6628,1652
DeKalb,Advance in Person,72480,"Public Service Commission, District 1 - Southern",56620,15860
DeKalb,Election Day,129376,"Public Service Commission, District 1 - Southern",105664,23712
DeKalb,Provisional,503,"Public Service Commission, District 1 - Southern",392,111
Decatur,Absentee by Mail,269,"Public Service Commission, District 1 - Southern",231,38
Decatur,Advance in Person,1985,"Public Service Commission, District 1 - Southern",1762,223
Decatur,Election Day,3820,"Public Service Commission, District 1 - Southern",3362,458
Decatur,Provisional,5,"Public Service Commission, District 1 - Southern",5,0
Dodge,Absentee by Mail,219,"Public Service Commission, District 1 - Southern",189,30
Dodge,Advance in Person,1690,"Public Service Commission, District 1 - Southern",1482,208
Dodge,Election Day,3173,"Public Service Commission, District 1 - Southern",2850,323
Dodge,Provisional,0,"Public Service Commission, District 1 - Southern",0,0
Dooly,Absentee by Mail,68,"Public Service Commission, District 1 - Southern",57,11
Dooly,Advance in Person,834,"Public Service Commission, District 1 - Southern",679,155
Dooly,Election Day,1783,"Public Service Commission, District 1 - Southern",1450,333
Dooly,Provisional,0,"Public Service Commission, District 1 - Southern",0,0
Dougherty,Absentee by Mail,1050,"Public Service Commission, District 1 - Southern",870,180
Dougherty,Advance in Person,6272,"Public Service Commission, District 1 - Southern",5070,1202
Dougherty,Election Day,16148,"Public Service Commission, District 1 - Southern",13880,2268
Dougherty,Provisional,41,"Public Service Commission, District 1 - Southern",35,6
Douglas,Absentee by Mail,1308,"Public Service Commission, District 1 - Southern",1185,123
Douglas,Advance in Person,15797,"Public Service Commission, District 1 - Southern",13730,2067
Douglas,Election Day,20398,"Public Service Commission, District 1 - Southern",18219,2179
Douglas,Provisional,27,"Public Service Commission, District 1 - Southern",21,6
Early,Absentee by Mail,140,"Public Service Commission, District 1 - Southern",95,45
Early,Advance in Person,890,"Public Service Commission, District 1 - Southern",702,188
Early,Election Day,2163,"Public Service Commission, District 1 - Southern",1779,384
Early,Provisional,3,"Public Service Commission, District 1 - Southern",2,1
Echols,Absentee by Mail,19,"Public Service Commission, District 1 - Southern",17,2
Echols,Advance in Person,243,"Public Service Commission, District 1 - Southern",224,19
Echols,Election Day,361,"Public Service Commission, District 1 - Southern",354,7
Echols,Provisional,0,"Public Service Commission, District 1 - Southern",0,0
Effingham,Absentee by Mail,373,"Public Service Commission, District 1 - Southern",342,31
Effingham,Advance in Person,3036,"Public Service Commission, District 1 - Southern",2822,214
Effingham,Election Day,9204,"Public Service Commission, District 1 - Southern",8675,529
Effingham,Provisional,10,"Public Service Commission, District 1 - Southern",8,2
Elbert,Absentee by Mail,219,"Public Service Commission, District 1 - Southern",186,33
Elbert,Advance in Person,1841,"Public Service Commission, District 1 - Southern",1621,220
Elbert,Election Day,2632,"Public Service Commission, District 1 - Southern",2423,209
Elbert,Provisional,11,"Public Service Commission, District 1 - Southern",11,0
Emanuel,Absentee by Mail,213,"Public Service Commission, District 1 - Southern",189,24
Emanuel,Advance in Person,1187,"Public Service Commission, District 1 - Southern",1042,145
Emanuel,Election Day,3581,"Public Service Commission, District 1 - Southern",3156,425
Emanuel,Provisional,1,"Public Service Commission, District 1 - Southern",1,0
Evans,Absentee by Mail,122,"Public Service Commission, District 1 - Southern",102,20
Evans,Advance in Person,921,"Public Service Commission, District 1 - Southern",841,80
Evans,Election Day,1107,"Public Service Commission, District 1 - Southern",1002,105
Evans,Provisional,0,"Public Service Commission, District 1 - Southern",0,0
Fannin,Absentee by Mail,417,"Public Service Commission, District 1 - Southern",380,37
Fannin,Advance in Person,2268,"Public Service Commission, District 1 - Southern",2086,182
Fannin,Election Day,4216,"Public Service Commission, District 1 - Southern",3958,258
Fannin,Provisional,3,"Public Service Commission, District 1 - Southern",2,1
Fayette,Absentee by Mail,1272,"Public Service Commission, District 1 - Southern",1143,129
Fayette,Advance in Person,18189,"Public Service Commission, District 1 - Southern",16074,2115
Fayette,Election Day,22606,"Public Service Commission, District 1 - Southern",20537,2069
Fayette,Provisional,13,"Public Service Commission, District 1 - Southern",10,3
Floyd,Absentee by Mail,771,"Public Service Commission, District 1 - Southern",685,86
Floyd,Advance in Person,5763,"Public Service Commission, District 1 - Southern",5140,623
Floyd,Election Day,14210,"Public Service Commission, District 1 - Southern",13227,983
Floyd,Provisional,78,"Public Service Commission, District 1 - Southern",68,10
Forsyth,Absentee by Mail,1655,"Public Service Commission, District 1 - Southern",1542,113
Forsyth,Advance in Person,22647,"Public Service Commission, District 1 - Southern",21487,1160
Forsyth,Election Day,32220,"Public Service Commission, District 1 - Southern",30692,1528
Forsyth,Provisional,48,"Public Service Commission, District 1 - Southern",43,5
Franklin,Absentee by Mail,198,"Public Service Commission, District 1 - Southern",182,16
Franklin,Advance in Person,1077,"Public Service Commission, District 1 - Southern",1032,45
Franklin,Election Day,3454,"Public Service Commission, District 1 - Southern",3312,142
Franklin,Provisional,1,"Public Service Commission, District 1 - Southern",1,0
Fulton,Absentee by Mail,8864,"Public Service Commission, District 1 - Southern",7334,1530
Fulton,Advance in Person,87201,"Public Service Commission, District 1 - Southern",70897,16304
Fulton,Election Day,167468,"Public Service Commission, District 1 - Southern",141667,25801
Fulton,Provisional,2135,"Public Service Commission, District 1 - Southern",1747,388
Gilmer,Absentee by Mail,378,"Public Service Commission, District 1 - Southern",360,18
Gilmer,Advance in Person,2578,"Public Service Commission, District 1 - Southern",2389,189
Gilmer,Election Day,4854,"Public Service Commission, District 1 - Southern",4540,314
Gilmer,Provisional,16,"Public Service Commission, District 1 - Southern",15,1
Glascock,Absentee by Mail,36,"Public Service Commission, District 1 - Southern",33,3
Glascock,Advance in Person,211,"Public Service Commission, District 1 - Southern",199,12
Glascock,Election Day,542,"Public Service Commission, District 1 - Southern",521,21
Glascock,Provisional,0,"Public Service Commission, District 1 - Southern",0,0
Glynn,Absentee by Mail,883,"Public Service Commission, District 1 - Southern",766,117
Glynn,Advance in Person,7098,"Public Service Commission, District 1 - Southern",6260,838
Glynn,Election Day,12102,"Public Service Commission, District 1 - Southern",10857,1245
Glynn,Provisional,36,"Public Service Commission, District 1 - Southern",32,4
Gordon,Absentee by Mail,370,"Public Service Commission, District 1 - Southern",343,27
Gordon,Advance in Person,2666,"Public Service Commission, District 1 - Southern",2403,263
Gordon,Election Day,7273,"Public Service Commission, District 1 - Southern",6812,461
Gordon,Provisional,16,"Public Service Commission, District 1 - Southern",13,3
Grady,Absentee by Mail,157,"Public Service Commission, District 1 - Southern",138,19
Grady,Advance in Person,1854,"Public Service Commission, District 1 - Southern",1677,177
Grady,Election Day,3548,"Public Service Commission, District 1 - Southern",3316,232
Grady,Provisional,6,"Public Service Commission, District 1 - Southern",5,1
Greene,Absentee by Mail,538,"Public Service Commission, District 1 - Southern",378,160
Greene,Advance in Person,3068,"Public Service Commission, District 1 - Southern",2823,245
Greene,Election Day,2907,"Public Service Commission, District 1 - Southern",2533,374
Greene,Provisional,10,"Public Service Commission, District 1 - Southern",8,2
Gwinnett,Absentee by Mail,8170,"Public Service Commission, District 1 - Southern",7435,735
Gwinnett,Advance in Person,47244,"Public Service Commission, District 1 - Southern",40399,6845
Gwinnett,Election Day,141636,"Public Service Commission, District 1 - Southern",127180,14456
Gwinnett,Provisional,1155,"Public Service Commission, District 1 - Southern",983,172
Habersham,Absentee by Mail,704,"Public Service Commission, District 1 - Southern",652,52
Habersham,Advance in Person,5381,"Public Service Commission, District 1 - Southern",5056,325
Habersham,Election Day,3529,"Public Service Commission, District 1 - Southern",3359,170
Habersham,Provisional,34,"Public Service Commission, District 1 - Southern",30,4
Hall,Absentee by Mail,2074,"Public Service Commission, District 1 - Southern",1904,170
Hall,Advance in Person,12299,"Public Service Commission, District 1 - Southern",11384,915
Hall,Election Day,29428,"Public Service Commission, District 1 - Southern",27866,1562
Hall,Provisional,42,"Public Service Commission, District 1 - Southern",39,3
Hancock,Absentee by Mail,283,"Public Service Commission, District 1 - Southern",200,83
Hancock,Advance in Person,839,"Public Service Commission, District 1 - Southern",554,285
Hancock,Election Day,1257,"Public Service Commission, District 1 - Southern",927,330
Hancock,Provisional,19,"Public Service Commission, District 1 - Southern",14,5
Haralson,Absentee by Mail,262,"Public Service Commission, District 1 - Southern",245,17
Haralson,Advance in Person,1563,"Public Service Commission, District 1 - Southern",1483,80
Haralson,Election Day,4986,"Public Service Commission, District 1 - Southern",4802,184
Haralson,Provisional,2,"Public Service Commission, District 1 - Southern",2,0
Harris,Absentee by Mail,493,"Public Service Commission, District 1 - Southern",449,44
Harris,Advance in Person,2950,"Public Service Commission, District 1 - Southern",2699,251
Harris,Election Day,6803,"Public Service Commission, District 1 - Southern",6346,457
Harris,Provisional,2,"Public Service Commission, District 1 - Southern",2,0
Hart,Absentee by Mail,287,"Public Service Commission, District 1 - Southern",267,20
Hart,Advance in Person,2309,"Public Service Commission, District 1 - Southern",2032,277
Hart,Election Day,4185,"Public Service Commission, District 1 - Southern",3853,332
Hart,Provisional,1,"Public Service Commission, District 1 - Southern",1,0
Heard,Absentee by Mail,157,"Public Service Commission, District 1 - Southern",136,21
Heard,Advance in Person,552,"Public Service Commission, District 1 - Southern",497,55
Heard,Election Day,1772,"Public Service Commission, District 1 - Southern",1633,139
Heard,Provisional,0,"Public Service Commission, District 1 - Southern",0,0
Henry,Absentee by Mail,2016,"Public Service Commission, District 1 - Southern",1822,194
Henry,Advance in Person,29231,"Public Service Commission, District 1 - Southern",25102,4129
Henry,Election Day,31732,"Public Service Commission, District 1 - Southern",28359,3373
Henry,Provisional,102,"Public Service Commission, District 1 - Southern",81,21
Houston,Absentee by Mail,1431,"Public Service Commission, District 1 - Southern",1283,148
Houston,Advance in Person,16400,"Public Service Commission, District 1 - Southern",14393,2007
Houston,Election Day,19454,"Public Service Commission, District 1 - Southern",17414,2040
Houston,Provisional,62,"Public Service Commission, District 1 - Southern",48,14
Irwin,Absentee by Mail,61,"Public Service Commission, District 1 - Southern",54,7
Irwin,Advance in Person,719,"Public Service Commission, District 1 - Southern",617,102
Irwin,Election Day,1581,"Public Service Commission, District 1 - Southern",1453,128
Irwin,Provisional,3,"Public Service Commission, District 1 - Southern",1,2
Jackson,Absentee by Mail,495,"Public Service Commission, District 1 - Southern",475,20
Jackson,Advance in Person,5419,"Public Service Commission, District 1 - Southern",5141,278
Jackson,Election Day,10060,"Public Service Commission, District 1 - Southern",9653,407
Jackson,Provisional,16,"Public Service Commission, District 1 - Southern",14,2
Jasper,Absentee by Mail,255,"Public Service Commission, District 1 - Southern",192,63
Jasper,Advance in Person,1280,"Public Service Commission, District 1 - Southern",1155,125
Jasper,Election Day,2305,"Public Service Commission, District 1 - Southern",2116,189
Jasper,Provisional,2,"Public Service Commission, District 1 - Southern",2,0
Jeff Davis,Absentee by Mail,153,"Public Service Commission, District 1 - Southern",135,18
Jeff Davis,Advance in Person,861,"Public Service Commission, District 1 - Southern",786,75
Jeff Davis,Election Day,1973,"Public Service Commission, District 1 - Southern",1778,195
Jeff Davis,Provisional,1,"Public Service Commission, District 1 - Southern",1,0
Jefferson,Absentee by Mail,216,"Public Service Commission, District 1 - Southern",111,105
Jefferson,Advance in Person,1158,"Public Service Commission, District 1 - Southern",894,264
Jefferson,Election Day,3144,"Public Service Commission, District 1 - Southern",2525,619
Jefferson,Provisional,20,"Public Service Commission, District 1 - Southern",15,5
Jenkins,Absentee by Mail,163,"Public Service Commission, District 1 - Southern",132,31
Jenkins,Advance in Person,671,"Public Service Commission, District 1 - Southern",589,82
Jenkins,Election Day,1088,"Public Service Commission, District 1 - Southern",926,162
Jenkins,Provisional,0,"Public Service Commission, District 1 - Southern",0,0
Johnson,Absentee by Mail,92,"Public Service Commission, District 1 - Southern",77,15
Johnson,Advance in Person,789,"Public Service Commission, District 1 - Southern",679,110
Johnson,Election Day,1415,"Public Service Commission, District 1 - Southern",1268,147
Johnson,Provisional,0,"Public Service Commission, District 1 - Southern",0,0
Jones,Absentee by Mail,511,"Public Service Commission, District 1 - Southern",448,63
Jones,Advance in Person,2913,"Public Service Commission, District 1 - Southern",2578,335
Jones,Election Day,4638,"Public Service Commission, District 1 - Southern",4217,421
Jones,Provisional,7,"Public Service Commission, District 1 - Southern",6,1
Lamar,Absentee by Mail,215,"Public Service Commission, District 1 - Southern",175,40
Lamar,Advance in Person,1700,"Public Service Commission, District 1 - Southern",1464,236
Lamar,Election Day,3046,"Public Service Commission, District 1 - Southern",2796,250
Lamar,Provisional,5,"Public Service Commission, District 1 - Southern",5,0
Lanier,Absentee by Mail,40,"Public Service Commission, District 1 - Southern",38,2
Lanier,Advance in Person,521,"Public Service Commission, District 1 - Southern",466,55
Lanier,Election Day,878,"Public Service Commission, District 1 - Southern",786,92
Lanier,Provisional,4,"Public Service Commission, District 1 - Southern",3,1
Laurens,Absentee by Mail,763,"Public Service Commission, District 1 - Southern",651,112
Laurens,Advance in Person,3953,"Public Service Commission, District 1 - Southern",3411,542
Laurens,Election Day,8153,"Public Service Commission, District 1 - Southern",7289,864
Laurens,Provisional,14,"Public Service Commission, District 1 - Southern",12,2
Lee,Absentee by Mail,241,"Public Service Commission, District 1 - Southern",214,27
Lee,Advance in Person,2107,"Public Service Commission, District 1 - Southern",1949,158
Lee,Election Day,6514,"Public Service Commission, District 1 - Southern",6167,347
Lee,Provisional,5,"Public Service Commission, District 1 - Southern",5,0
Liberty,Absentee by Mail,209,"Public Service Commission, District 1 - Southern",165,44
Liberty,Advance in Person,3652,"Public Service Commission, District 1 - Southern",2887,765
Liberty,Election Day,5097,"Public Service Commission, District 1 - Southern",4425,672
Liberty,Provisional,4,"Public Service Commission, District 1 - Southern",3,1
Lincoln,Absentee by Mail,222,"Public Service Commission, District 1 - Southern",142,80
Lincoln,Advance in Person,899,"Public Service Commission, District 1 - Southern",771,128
Lincoln,Election Day,1554,"Public Service Commission, District 1 - Southern",1391,163
Lincoln,Provisional,13,"Public Service Commission, District 1 - Southern",12,1
Long,Absentee by Mail,40,"Public Service Commission, District 1 - Southern",36,4
Long,Advance in Person,691,"Public Service Commission, District 1 - Southern",622,69
Long,Election Day,1397,"Public Service Commission, District 1 - Southern",1282,115
Long,Provisional,6,"Public Service Commission, District 1 - Southern",6,0
Lowndes,Absentee by Mail,532,"Public Service Commission, District 1 - Southern",468,64
Lowndes,Advance in Person,8813,"Public Service Commission, District 1 - Southern",7645,1168
Lowndes,Election Day,11478,"Public Service Commission, District 1 - Southern",10195,1283
Lowndes,Provisional,560,"Public Service Commission, District 1 - Southern",494,66
Lumpkin,Absentee by Mail,305,"Public Service Commission, District 1 - Southern",279,26
Lumpkin,Advance in Person,2933,"Public Service Commission, District 1 - Southern",2726,207
Lumpkin,Election Day,4404,"Public Service Commission, District 1 - Southern",4186,218
Lumpkin,Provisional,15,"Public Service Commission, District 1 - Southern",14,1
Macon,Absentee by Mail,106,"Public Service Commission, District 1 - Southern",87,19
Macon,Advance in Person,1207,"Public Service Commission, District 1 - Southern",921,286
Macon,Election Day,1695,"Public Service Commission, District 1 - Southern",1306,389
Macon,Provisional,0,"Public Service Commission, District 1 - Southern",0,0
Madison,Absentee by Mail,312,"Public Service Commission, District 1 - Southern",286,26
Madison,Advance in Person,2257,"Public Service Commission, District 1 - Southern",2094,163
Madison,Election Day,4970,"Public Service Commission, District 1 - Southern",4655,315
Madison,Provisional,6,"Public Service Commission, District 1 - Southern",6,0
Marion,Absentee by Mail,219,"Public Service Commission, District 1 - Southern",135,84
Marion,Advance in Person,612,"Public Service Commission, District 1 - Southern",501,111
Marion,Election Day,1314,"Public Service Commission, District 1 - Southern",1199,115
Marion,Provisional,0,"Public Service Commission, District 1 - Southern",0,0
McDuffie,Absentee by Mail,351,"Public Service Commission, District 1 - Southern",292,59
McDuffie,Advance in Person,2043,"Public Service Commission, District 1 - Southern",1675,368
McDuffie,Election Day,3653,"Public Service Commission, District 1 - Southern",3298,355
McDuffie,Provisional,3,"Public Service Commission, District 1 - Southern",3,0
McIntosh,Absentee by Mail,300,"Public Service Commission, District 1 - Southern",252,48
McIntosh,Advance in Person,1300,"Public Service Commission, District 1 - Southern",1129,171
McIntosh,Election Day,2233,"Public Service Commission, District 1 - Southern",1847,386
McIntosh,Provisional,7,"Public Service Commission, District 1 - Southern",6,1
Meriwether,Absentee by Mail,207,"Public Service Commission, District 1 - Southern",194,13
Meriwether,Advance in Person,1188,"Public Service Commission, District 1 - Southern",1023,165
Meriwether,Election Day,4671,"Public Service Commission, District 1 - Southern",4039,632
Meriwether,Provisional,1,"Public Service Commission, District 1 - Southern",1,0
Miller,Absentee by Mail,53,"Public Service Commission, District 1 - Southern",49,4
Miller,Advance in Person,436,"Public Service Commission, District 1 - Southern",401,35
Miller,Election Day,937,"Public Service Commission, District 1 - Southern",838,99
Miller,Provisional,1,"Public Service Commission, District 1 - Southern",1,0
Mitchell,Absentee by Mail,202,"Public Service Commission, District 1 - Southern",161,41
Mitchell,Advance in Person,1589,"Public Service Commission, District 1 - Southern",1344,245
Mitchell,Election Day,3215,"Public Service Commission, District 1 - Southern",2871,344
Mitchell,Provisional,3,"Public Service Commission, District 1 - Southern",3,0
Monroe,Absentee by Mail,358,"Public Service Commission, District 1 - Southern",274,84
Monroe,Advance in Person,2523,"Public Service Commission, District 1 - Southern",2219,304
Monroe,Election Day,5671,"Public Service Commission, District 1 - Southern",5254,417
Monroe,Provisional,23,"Public Service Commission, District 1 - Southern",21,2
Montgomery,Absentee by Mail,92,"Public Service Commission, District 1 - Southern",80,12
Montgomery,Advance in Person,463,"Public Service Commission, District 1 - Southern",409,54
Montgomery,Election Day,1730,"Public Service Commission, District 1 - Southern",1570,160
Montgomery,Provisional,0,"Public Service Commission, District 1 - Southern",0,0
Morgan,Absentee by Mail,193,"Public Service Commission, District 1 - Southern",171,22
Morgan,Advance in Person,2475,"Public Service Commission, District 1 - Southern",2204,271
Morgan,Election Day,3635,"Public Service Commission, District 1 - Southern",3370,265
Morgan,Provisional,7,"Public Service Commission, District 1 - Southern",6,1
Murray,Absentee by Mail,207,"Public Service Commission, District 1 - Southern",187,20
Murray,Advance in Person,1347,"Public Service Commission, District 1 - Southern",1241,106
Murray,Election Day,4497,"Public Service Commission, District 1 - Southern",4234,263
Murray,Provisional,0,"Public Service Commission, District 1 - Southern",0,0
Muscogee,Absentee by Mail,2150,"Public Service Commission, District 1 - Southern",1872,278
Muscogee,Advance in Person,13494,"Public Service Commission, District 1 - Southern",11068,2426
Muscogee,Election Day,25301,"Public Service Commission, District 1 - Southern",22412,2889
Muscogee,Provisional,63,"Public Service Commission, District 1 - Southern",55,8
Newton,Absentee by Mail,1136,"Public Service Commission, District 1 - Southern",984,152
Newton,Advance in Person,10430,"Public Service Commission, District 1 - Southern",8818,1612
Newton,Election Day,16634,"Public Service Commission, District 1 - Southern",14933,1701
Newton,Provisional,2,"Public Service Commission, District 1 - Southern",2,0
Oconee,Absentee by Mail,368,"Public Service Commission, District 1 - Southern",327,41
Oconee,Advance in Person,5438,"Public Service Commission, District 1 - Southern",4949,489
Oconee,Election Day,7726,"Public Service Commission, District 1 - Southern",7080,646
Oconee,Provisional,7,"Public Service Commission, District 1 - Southern",6,1
Oglethorpe,Absentee by Mail,217,"Public Service Commission, District 1 - Southern",202,15
Oglethorpe,Advance in Person,1609,"Public Service Commission, District 1 - Southern",1436,173
Oglethorpe,Election Day,2262,"Public Service Commission, District 1 - Southern",2081,181
Oglethorpe,Provisional,4,"Public Service Commission, District 1 - Southern",4,0
Paulding,Absentee by Mail,1789,"Public Service Commission, District 1 - Southern",1650,139
Paulding,Advance in Person,14824,"Public Service Commission, District 1 - Southern",13547,1277
Paulding,Election Day,19620,"Public Service Commission, District 1 - Southern",18309,1311
Paulding,Provisional,29,"Public Service Commission, District 1 - Southern",25,4
Peach,Absentee by Mail,215,"Public Service Commission, District 1 - Southern",175,40
Peach,Advance in Person,3402,"Public Service Commission, District 1 - Southern",2828,574
Peach,Election Day,3620,"Public Service Commission, District 1 - Southern",3201,419
Peach,Provisional,8,"Public Service Commission, District 1 - Southern",7,1
Pickens,Absentee by Mail,138,"Public Service Commission, District 1 - Southern",130,8
Pickens,Advance in Person,3653,"Public Service Commission, District 1 - Southern",3422,231
Pickens,Election Day,5031,"Public Service Commission, District 1 - Southern",4812,219
Pickens,Provisional,1,"Public Service Commission, District 1 - Southern",1,0
Pierce,Absentee by Mail,228,"Public Service Commission, District 1 - Southern",212,16
Pierce,Advance in Person,1629,"Public Service Commission, District 1 - Southern",1554,75
Pierce,Election Day,2106,"Public Service Commission, District 1 - Southern",2008,98
Pierce,Provisional,0,"Public Service Commission, District 1 - Southern",0,0
Pike,Absentee by Mail,246,"Public Service Commission, District 1 - Southern",224,22
Pike,Advance in Person,1650,"Public Service Commission, District 1 - Southern",1550,100
Pike,Election Day,3700,"Public Service Commission, District 1 - Southern",3530,170
Pike,Provisional,8,"Public Service Commission, District 1 - Southern",7,1
Polk,Absentee by Mail,235,"Public Service Commission, District 1 - Southern",211,24
Polk,Advance in Person,3214,"Public Service Commission, District 1 - Southern",2937,277
Polk,Election Day,4537,"Public Service Commission, District 1 - Southern",4252,285
Polk,Provisional,4,"Public Service Commission, District 1 - Southern",4,0
Pulaski,Absentee by Mail,86,"Public Service Commission, District 1 - Southern",66,20
Pulaski,Advance in Person,1249,"Public Service Commission, District 1 - Southern",1094,155
Pulaski,Election Day,1013,"Public Service Commission, District 1 - Southern",908,105
Pulaski,Provisional,2,"Public Service Commission, District 1 - Southern",2,0
Putnam,Absentee by Mail,387,"Public Service Commission, District 1 - Southern",345,42
Putnam,Advance in Person,2434,"Public Service Commission, District 1 - Southern",2170,264
Putnam,Election Day,3451,"Public Service Commission, District 1 - Southern",3161,290
Putnam,Provisional,2,"Public Service Commission, District 1 - Southern",1,1
Quitman,Absentee by Mail,41,"Public Service Commission, District 1 - Southern",37,4
Quitman,Advance in Person,209,"Public Service Commission, District 1 - Southern",162,47
Quitman,Election Day,347,"Public Service Commission, District 1 - Southern",275,72
Quitman,Provisional,1,"Public Service Commission, District 1 - Southern",1,0
Rabun,Absentee by Mail,427,"Public Service Commission, District 1 - Southern",384,43
Rabun,Advance in Person,3295,"Public Service Commission, District 1 - Southern",2994,301
Rabun,Election Day,1731,"Public Service Commission, District 1 - Southern",1597,134
Rabun,Provisional,0,"Public Service Commission, District 1 - Southern",0,0
Randolph,Absentee by Mail,149,"Public Service Commission, District 1 - Southern",77,72
Randolph,Advance in Person,789,"Public Service Commission, District 1 - Southern",634,155
Randolph,Election Day,1173,"Public Service Commission, District 1 - Southern",982,191
Randolph,Provisional,7,"Public Service Commission, District 1 - Southern",6,1
Richmond,Absentee by Mail,3207,"Public Service Commission, District 1 - Southern",2569,638
Richmond,Advance in Person,13314,"Public Service Commission, District 1 - Southern",10704,2610
Richmond,Election Day,31248,"Public Service Commission, District 1 - Southern",26213,5035
Richmond,Provisional,71,"Public Service Commission, District 1 - Southern",56,15
Rockdale,Absentee by Mail,825,"Public Service Commission, District 1 - Southern",728,97
Rockdale,Advance in Person,13442,"Public Service Commission, District 1 - Southern",11338,2104
Rockdale,Election Day,12256,"Public Service Commission, District 1 - Southern",10708,1548
Rockdale,Provisional,48,"Public Service Commission, District 1 - Southern",41,7
Schley,Absentee by Mail,66,"Public Service Commission, District 1 - Southern",52,14
Schley,Advance in Person,602,"Public Service Commission, District 1 - Southern",552,50
Schley,Election Day,595,"Public Service Commission, District 1 - Southern",547,48
Schley,Provisional,3,"Public Service Commission, District 1 - Southern",3,0
Screven,Absentee by Mail,158,"Public Service Commission, District 1 - Southern",129,29
Screven,Advance in Person,1201,"Public Service Commission, District 1 - Southern",1024,177
Screven,Election Day,2412,"Public Service Commission, District 1 - Southern",2098,314
Screven,Provisional,4,"Public Service Commission, District 1 - Southern",4,0
Seminole,Absentee by Mail,76,"Public Service Commission, District 1 - Southern",64,12
Seminole,Advance in Person,477,"Public Service Commission, District 1 - Southern",423,54
Seminole,Election Day,1698,"Public Service Commission, District 1 - Southern",1498,200
Seminole,Provisional,5,"Public Service Commission, District 1 - Southern",5,0
Spalding,Absentee by Mail,528,"Public Service Commission, District 1 - Southern",458,70
Spalding,Advance in Person,6771,"Public Service Commission, District 1 - Southern",5798,973
Spalding,Election Day,9378,"Public Service Commission, District 1 - Southern",8444,934
Spalding,Provisional,14,"Public Service Commission, District 1 - Southern",8,6
Stephens,Absentee by Mail,337,"Public Service Commission, District 1 - Southern",319,18
Stephens,Advance in Person,2604,"Public Service Commission, District 1 - Southern",2441,163
Stephens,Election Day,2225,"Public Service Commission, District 1 - Southern",2133,92
Stephens,Provisional,2,"Public Service Commission, District 1 - Southern",2,0
Stewart,Absentee by Mail,75,"Public Service Commission, District 1 - Southern",55,20
Stewart,Advance in Person,311,"Public Service Commission, District 1 - Southern",221,90
Stewart,Election Day,808,"Public Service Commission, District 1 - Southern",579,229
Stewart,Provisional,18,"Public Service Commission, District 1 - Southern",15,3
Sumter,Absentee by Mail,522,"Public Service Commission, District 1 - Southern",399,123
Sumter,Advance in Person,3280,"Public Service Commission, District 1 - Southern",2650,630
Sumter,Election Day,4191,"Public Service Commission, District 1 - Southern",3572,619
Sumter,Provisional,5,"Public Service Commission, District 1 - Southern",5,0
Talbot,Absentee by Mail,215,"Public Service Commission, District 1 - Southern",148,67
Talbot,Advance in Person,342,"Public Service Commission, District 1 - Southern",267,75
Talbot,Election Day,1588,"Public Service Commission, District 1 - Southern",1284,304
Talbot,Provisional,2,"Public Service Commission, District 1 - Southern",2,0
Taliaferro,Absentee by Mail,50,"Public Service Commission, District 1 - Southern",31,19
Taliaferro,Advance in Person,197,"Public Service Commission, District 1 - Southern",150,47
Taliaferro,Election Day,311,"Public Service Commission, District 1 - Southern",233,78
Taliaferro,Provisional,0,"Public Service Commission, District 1 - Southern",0,0
Tattnall,Absentee by Mail,198,"Public Service Commission, District 1 - Southern",176,22
Tattnall,Advance in Person,1310,"Public Service Commission, District 1 - Southern",1167,143
Tattnall,Election Day,2706,"Public Service Commission, District 1 - Southern",2488,218
Tattnall,Provisional,6,"Public Service Commission, District 1 - Southern",5,1
Taylor,Absentee by Mail,127,"Public Service Commission, District 1 - Southern",95,32
Taylor,Advance in Person,620,"Public Service Commission, District 1 - Southern",568,52
Taylor,Election Day,1441,"Public Service Commission, District 1 - Southern",1249,192
Taylor,Provisional,0,"Public Service Commission, District 1 - Southern",0,0
Telfair,Absentee by Mail,227,"Public Service Commission, District 1 - Southern",162,65
Telfair,Advance in Person,751,"Public Service Commission, District 1 - Southern",641,110
Telfair,Election Day,1723,"Public Service Commission, District 1 - Southern",1481,242
Telfair,Provisional,0,"Public Service Commission, District 1 - Southern",0,0
Terrell,Absentee by Mail,258,"Public Service Commission, District 1 - Southern",189,69
Terrell,Advance in Person,1101,"Public Service Commission, District 1 - Southern",898,203
Terrell,Election Day,1887,"Public Service Commission, District 1 - Southern",1651,236
Terrell,Provisional,2,"Public Service Commission, District 1 - Southern",2,0
Thomas,Absentee by Mail,293,"Public Service Commission, District 1 - Southern",246,47
Thomas,Advance in Person,3653,"Public Service Commission, District 1 - Southern",3259,394
Thomas,Election Day,7055,"Public Service Commission, District 1 - Southern",6370,685
Thomas,Provisional,2,"Public Service Commission, District 1 - Southern",2,0
Tift,Absentee by Mail,254,"Public Service Commission, District 1 - Southern",225,29
Tift,Advance in Person,3128,"Public Service Commission, District 1 - Southern",2841,287
Tift,Election Day,5030,"Public Service Commission, District 1 - Southern",4474,556
Tift,Provisional,92,"Public Service Commission, District 1 - Southern",75,17
Toombs,Absentee by Mail,381,"Public Service Commission, District 1 - Southern",285,96
Toombs,Advance in Person,1805,"Public Service Commission, District 1 - Southern",1653,152
Toombs,Election Day,3352,"Public Service Commission, District 1 - Southern",3055,297
Toombs,Provisional,6,"Public Service Commission, District 1 - Southern",6,0
Towns,Absentee by Mail,190,"Public Service Commission, District 1 - Southern",173,17
Towns,Advance in Person,2289,"Public Service Commission, District 1 - Southern",2083,206
Towns,Election Day,1717,"Public Service Commission, District 1 - Southern",1568,149
Towns,Provisional,68,"Public Service Commission, District 1 - Southern",61,7
Treutlen,Absentee by Mail,50,"Public Service Commission, District 1 - Southern",40,10
Treutlen,Advance in Person,426,"Public Service Commission, District 1 - Southern",334,92
Treutlen,Election Day,1041,"Public Service Commission, District 1 - Southern",922,119
Treutlen,Provisional,3,"Public Service Commission, District 1 - Southern",2,1
Troup,Absentee by Mail,847,"Public Service Commission, District 1 - Southern",719,128
Troup,Advance in Person,4821,"Public Service Commission, District 1 - Southern",4239,582
Troup,Election Day,9963,"Public Service Commission, District 1 - Southern",8952,1011
Troup,Provisional,41,"Public Service Commission, District 1 - Southern",38,3
Turner,Absentee by Mail,41,"Public Service Commission, District 1 - Southern",29,12
Turner,Advance in Person,1026,"Public Service Commission, District 1 - Southern",894,132
Turner,Election Day,1188,"Public Service Commission, District 1 - Southern",1051,137
Turner,Provisional,11,"Public Service Commission, District 1 - Southern",7,4
Twiggs,Absentee by Mail,275,"Public Service Commission, District 1 - Southern",186,89
Twiggs,Advance in Person,841,"Public Service Commission, District 1 - Southern",657,184
Twiggs,Election Day,1776,"Public Service Commission, District 1 - Southern",1506,270
Twiggs,Provisional,1,"Public Service Commission, District 1 - Southern",1,0
Union,Absentee by Mail,288,"Public Service Commission, District 1 - Southern",259,29
Union,Advance in Person,3487,"Public Service Commission, District 1 - Southern",3232,255
Union,Election Day,3966,"Public Service Commission, District 1 - Southern",3737,229
Union,Provisional,2,"Public Service Commission, District 1 - Southern",2,0
Upson,Absentee by Mail,230,"Public Service Commission, District 1 - Southern",205,25
Upson,Advance in Person,2400,"Public Service Commission, District 1 - Southern",2128,272
Upson,Election Day,4440,"Public Service Commission, District 1 - Southern",4008,432
Upson,Provisional,1,"Public Service Commission, District 1 - Southern",1,0
Walker,Absentee by Mail,617,"Public Service Commission, District 1 - Southern",574,43
Walker,Advance in Person,3646,"Public Service Commission, District 1 - Southern",3413,233
Walker,Election Day,8076,"Public Service Commission, District 1 - Southern",7678,398
Walker,Provisional,0,"Public Service Commission, District 1 - Southern",0,0
Walton,Absentee by Mail,1068,"Public Service Commission, District 1 - Southern",967,101
Walton,Advance in Person,6096,"Public Service Commission, District 1 - Southern",5607,489
Walton,Election Day,18659,"Public Service Commission, District 1 - Southern",17642,1017
Walton,Provisional,16,"Public Service Commission, District 1 - Southern",15,1
Ware,Absentee by Mail,326,"Public Service Commission, District 1 - Southern",311,15
Ware,Advance in Person,2081,"Public Service Commission, District 1 - Southern",1804,277
Ware,Election Day,4306,"Public Service Commission, District 1 - Southern",3998,308
Ware,Provisional,1,"Public Service Commission, District 1 - Southern",1,0
Warren,Absentee by Mail,60,"Public Service Commission, District 1 - Southern",54,6
Warren,Advance in Person,543,"Public Service Commission, District 1 - Southern",414,129
Warren,Election Day,889,"Public Service Commission, District 1 - Southern",725,164
Warren,Provisional,1,"Public Service Commission, District 1 - Southern",1,0
Washington,Absentee by Mail,355,"Public Service Commission, District 1 - Southern",271,84
Washington,Advance in Person,2324,"Public Service Commission, District 1 - Southern",1834,490
Washington,Election Day,3362,"Public Service Commission, District 1 - Southern",2691,671
Washington,Provisional,8,"Public Service Commission, District 1 - Southern",7,1
Wayne,Absentee by Mail,258,"Public Service Commission, District 1 - Southern",230,28
Wayne,Advance in Person,2152,"Public Service Commission, District 1 - Southern",1982,170
Wayne,Election Day,3740,"Public Service Commission, District 1 - Southern",3495,245
Wayne,Provisional,0,"Public Service Commission, District 1 - Southern",0,0
Webster,Absentee by Mail,80,"Public Service Commission, District 1 - Southern",61,19
Webster,Advance in Person,271,"Public Service Commission, District 1 - Southern",236,35
Webster,Election Day,426,"Public Service Commission, District 1 - Southern",340,86
Webster,Provisional,0,"Public Service Commission, District 1 - Southern",0,0
Wheeler,Absentee by Mail,87,"Public Service Commission, District 1 - Southern",70,17
Wheeler,Advance in Person,447,"Public Service Commission, District 1 - Southern",379,68
Wheeler,Election Day,959,"Public Service Commission, District 1 - Southern",865,94
Wheeler,Provisional,9,"Public Service Commission, District 1 - Southern",9,0
White,Absentee by Mail,447,"Public Service Commission, District 1 - Southern",425,22
White,Advance in Person,2267,"Public Service Commission, District 1 - Southern",2150,117
White,Election Day,4948,"Public Service Commission, District 1 - Southern",4737,211
White,Provisional,3,"Public Service Commission, District 1 - Southern",3,0
Whitfield,Absentee by Mail,478,"Public Service Commission, District 1 - Southern",451,27
Whitfield,Advance in Person,3511,"Public Service Commission, District 1 - Southern",3176,335
Whitfield,Election Day,11767,"Public Service Commission, District 1 - Southern",11031,736
Whitfield,Provisional,38,"Public Service Commission, District 1 - Southern",38,0
Wilcox,Absentee by Mail,144,"Public Service Commission, District 1 - Southern",132,12
Wilcox,Advance in Person,455,"Public Service Commission, District 1 - Southern",407,48
Wilcox,Election Day,1280,"Public Service Commission, District 1 - Southern",1134,146
Wilcox,Provisional,3,"Public Service Commission, District 1 - Southern",2,1
Wilkes,Absentee by Mail,104,"Public Service Commission, District 1 - Southern",87,17
Wilkes,Advance in Person,939,"Public Service Commission, District 1 - Southern",779,160
Wilkes,Election Day,2044,"Public Service Commission, District 1 - Southern",1718,326
Wilkes,Provisional,3,"Public Service Commission, District 1 - Southern",3,0
Wilkinson,Absentee by Mail,150,"Public Service Commission, District 1 - Southern",114,36
Wilkinson,Advance in Person,763,"Public Service Commission, District 1 - Southern",589,174
Wilkinson,Election Day,2227,"Public Service Commission, District 1 - Southern",1845,382
Wilkinson,Provisional,1,"Public Service Commission, District 1 - Southern",1,0
Worth,Absentee by Mail,138,"Public Service Commission, District 1 - Southern",108,30
Worth,Advance in Person,1170,"Public Service Commission, District 1 - Southern",1060,110
Worth,Election Day,3871,"Public Service Commission, District 1 - Southern",3615,256
Worth,Provisional,10,"Public Service Commission, District 1 - Southern",10,0
Appling,Absentee by Mail,306,"Public Service Commission, District 4 - Northern",299,7
Appling,Advance in Person,976,"Public Service Commission, District 4 - Northern",964,12
Appling,Election Day,3122,"Public Service Commission, District 4 - Northern",3078,44
Appling,Provisional,4,"Public Service Commission, District 4 - Northern",4,0
Atkinson,Absentee by Mail,68,"Public Service Commission, District 4 - Northern",66,2
Atkinson,Advance in Person,495,"Public Service Commission, District 4 - Northern",477,18
Atkinson,Election Day,1058,"Public Service Commission, District 4 - Northern",1008,50
Atkinson,Provisional,7,"Public Service Commission, District 4 - Northern",6,1
Bacon,Absentee by Mail,73,"Public Service Commission, District 4 - Northern",71,2
Bacon,Advance in Person,887,"Public Service Commission, District 4 - Northern",869,18
Bacon,Election Day,1240,"Public Service Commission, District 4 - Northern",1232,8
Bacon,Provisional,3,"Public Service Commission, District 4 - Northern",3,0
Baker,Absentee by Mail,71,"Public Service Commission, District 4 - Northern",67,4
Baker,Advance in Person,298,"Public Service Commission, District 4 - Northern",296,2
Baker,Election Day,617,"Public Service Commission, District 4 - Northern",603,14
Baker,Provisional,3,"Public Service Commission, District 4 - Northern",3,0
Baldwin,Absentee by Mail,409,"Public Service Commission, District 4 - Northern",398,11
Baldwin,Advance in Person,3933,"Public Service Commission, District 4 - Northern",3896,37
Baldwin,Election Day,6152,"Public Service Commission, District 4 - Northern",6129,23
Baldwin,Provisional,9,"Public Service Commission, District 4 - Northern",9,0
Banks,Absentee by Mail,142,"Public Service Commission, District 4 - Northern",138,4
Banks,Advance in Person,852,"Public Service Commission, District 4 - Northern",836,16
Banks,Election Day,3339,"Public Service Commission, District 4 - Northern",3264,75
Banks,Provisional,1,"Public Service Commission, District 4 - Northern",1,0
Barrow,Absentee by Mail,701,"Public Service Commission, District 4 - Northern",686,15
Barrow,Advance in Person,4720,"Public Service Commission, District 4 - Northern",4693,27
Barrow,Election Day,10688,"Public Service Commission, District 4 - Northern",10588,100
Barrow,Provisional,8,"Public Service Commission, District 4 - Northern",7,1
Bartow,Absentee by Mail,772,"Public Service Commission, District 4 - Northern",747,25
Bartow,Advance in Person,5826,"Public Service Commission, District 4 - Northern",5802,24
Bartow,Election Day,16152,"Public Service Commission, District 4 - Northern",15941,211
Bartow,Provisional,20,"Public Service Commission, District 4 - Northern",20,0
Ben Hill,Absentee by Mail,136,"Public Service Commission, District 4 - Northern",129,7
Ben Hill,Advance in Person,1494,"Public Service Commission, District 4 - Northern",1476,18
Ben Hill,Election Day,1864,"Public Service Commission, District 4 - Northern",1862,2
Ben Hill,Provisional,3,"Public Service Commission, District 4 - Northern",3,0
Berrien,Absentee by Mail,212,"Public Service Commission, District 4 - Northern",203,9
Berrien,Advance in Person,1103,"Public Service Commission, District 4 - Northern",1092,11
Berrien,Election Day,2608,"Public Service Commission, District 4 - Northern",2589,19
Berrien,Provisional,8,"Public Service Commission, District 4 - Northern",8,0
Bibb,Absentee by Mail,2189,"Public Service Commission, District 4 - Northern",2123,66
Bibb,Advance in Person,10315,"Public Service Commission, District 4 - Northern",10250,65
Bibb,Election Day,29989,"Public Service Commission, District 4 - Northern",29604,385
Bibb,Provisional,78,"Public Service Commission, District 4 - Northern",77,1
Bleckley,Absentee by Mail,228,"Public Service Commission, District 4 - Northern",220,8
Bleckley,Advance in Person,1157,"Public Service Commission, District 4 - Northern",1128,29
Bleckley,Election Day,1855,"Public Service Commission, District 4 - Northern",1843,12
Bleckley,Provisional,5,"Public Service Commission, District 4 - Northern",4,1
Brantley,Absentee by Mail,143,"Public Service Commission, District 4 - Northern",137,6
Brantley,Advance in Person,747,"Public Service Commission, District 4 - Northern",735,12
Brantley,Election Day,2086,"Public Service Commission, District 4 - Northern",2035,51
Brantley,Provisional,4,"Public Service Commission, District 4 - Northern",4,0
Brooks,Absentee by Mail,1016,"Public Service Commission, District 4 - Northern",998,18
Brooks,Advance in Person,1259,"Public Service Commission, District 4 - Northern",1242,17
Brooks,Election Day,2355,"Public Service Commission, District 4 - Northern",2328,27
Brooks,Provisional,26,"Public Service Commission, District 4 - Northern",25,1
Bryan,Absentee by Mail,237,"Public Service Commission, District 4 - Northern",228,9
Bryan,Advance in Person,2852,"Public Service Commission, District 4 - Northern",2829,23
Bryan,Election Day,4863,"Public Service Commission, District 4 - Northern",4826,37
Bryan,Provisional,3,"Public Service Commission, District 4 - Northern",3,0
Bulloch,Absentee by Mail,541,"Public Service Commission, District 4 - Northern",526,15
Bulloch,Advance in Person,3846,"Public Service Commission, District 4 - Northern",3826,20
Bulloch,Election Day,9455,"Public Service Commission, District 4 - Northern",9346,109
Bulloch,Provisional,12,"Public Service Commission, District 4 - Northern",11,1
Burke,Absentee by Mail,594,"Public Service Commission, District 4 - Northern",588,6
Burke,Advance in Person,1260,"Public Service Commission, District 4 - Northern",1254,6
Burke,Election Day,4049,"Public Service Commission, District 4 - Northern",4015,34
Burke,Provisional,0,"Public Service Commission, District 4 - Northern",0,0
Butts,Absentee by Mail,183,"Public Service Commission, District 4 - Northern",180,3
Butts,Advance in Person,3252,"Public Service Commission, District 4 - Northern",3218,34
Butts,Election Day,2671,"Public Service Commission, District 4 - Northern",2651,20
Butts,Provisional,0,"Public Service Commission, District 4 - Northern",0,0
Calhoun,Absentee by Mail,91,"Public Service Commission, District 4 - Northern",87,4
Calhoun,Advance in Person,320,"Public Service Commission, District 4 - Northern",319,1
Calhoun,Election Day,1044,"Public Service Commission, District 4 - Northern",1039,5
Calhoun,Provisional,2,"Public Service Commission, District 4 - Northern",2,0
Camden,Absentee by Mail,586,"Public Service Commission, District 4 - Northern",573,13
Camden,Advance in Person,2509,"Public Service Commission, District 4 - Northern",2472,37
Camden,Election Day,6720,"Public Service Commission, District 4 - Northern",6673,47
Camden,Provisional,9,"Public Service Commission, District 4 - Northern",9,0
Candler,Absentee by Mail,108,"Public Service Commission, District 4 - Northern",104,4
Candler,Advance in Person,835,"Public Service Commission, District 4 - Northern",831,4
Candler,Election Day,1258,"Public Service Commission, District 4 - Northern",1246,12
Candler,Provisional,0,"Public Service Commission, District 4 - Northern",0,0
Carroll,Absentee by Mail,845,"Public Service Commission, District 4 - Northern",829,16
Carroll,Advance in Person,7673,"Public Service Commission, District 4 - Northern",7592,81
Carroll,Election Day,17495,"Public Service Commission, District 4 - Northern",17366,129
Carroll,Provisional,53,"Public Service Commission, District 4 - Northern",52,1
Catoosa,Absentee by Mail,456,"Public Service Commission, District 4 - Northern",435,21
Catoosa,Advance in Person,4909,"Public Service Commission, District 4 - Northern",4852,57
Catoosa,Election Day,8541,"Public Service Commission, District 4 - Northern",8380,161
Catoosa,Provisional,14,"Public Service Commission, District 4 - Northern",14,0
Charlton,Absentee by Mail,80,"Public Service Commission, District 4 - Northern",78,2
Charlton,Advance in Person,684,"Public Service Commission, District 4 - Northern",683,1
Charlton,Election Day,1247,"Public Service Commission, District 4 - Northern",1243,4
Charlton,Provisional,4,"Public Service Commission, District 4 - Northern",4,0
Chatham,Absentee by Mail,2948,"Public Service Commission, District 4 - Northern",2839,109
Chatham,Advance in Person,17241,"Public Service Commission, District 4 - Northern",17171,70
Chatham,Election Day,48480,"Public Service Commission, District 4 - Northern",48166,314
Chatham,Provisional,55,"Public Service Commission, District 4 - Northern",52,3
Chattahoochee,Absentee by Mail,22,"Public Service Commission, District 4 - Northern",22,0
Chattahoochee,Advance in Person,196,"Public Service Commission, District 4 - Northern",196,0
Chattahoochee,Election Day,481,"Public Service Commission, District 4 - Northern",481,0
Chattahoochee,Provisional,2,"Public Service Commission, District 4 - Northern",2,0
Chattooga,Absentee by Mail,107,"Public Service Commission, District 4 - Northern",106,1
Chattooga,Advance in Person,1625,"Public Service Commission, District 4 - Northern",1588,37
Chattooga,Election Day,3090,"Public Service Commission, District 4 - Northern",3042,48
Chattooga,Provisional,2,"Public Service Commission, District 4 - Northern",2,0
Cherokee,Absentee by Mail,2440,"Public Service Commission, District 4 - Northern",2334,106
Cherokee,Advance in Person,23437,"Public Service Commission, District 4 - Northern",22990,447
Cherokee,Election Day,40811,"Public Service Commission, District 4 - Northern",39867,944
Cherokee,Provisional,31,"Public Service Commission, District 4 - Northern",28,3
Clarke,Absentee by Mail,1152,"Public Service Commission, District 4 - Northern",1112,40
Clarke,Advance in Person,7332,"Public Service Commission, District 4 - Northern",7203,129
Clarke,Election Day,16976,"Public Service Commission, District 4 - Northern",16487,489
Clarke,Provisional,76,"Public Service Commission, District 4 - Northern",74,2
Clay,Absentee by Mail,90,"Public Service Commission, District 4 - Northern",82,8
Clay,Advance in Person,244,"Public Service Commission, District 4 - Northern",244,0
Clay,Election Day,602,"Public Service Commission, District 4 - Northern",602,0
Clay,Provisional,1,"Public Service Commission, District 4 - Northern",1,0
Clayton,Absentee by Mail,1772,"Public Service Commission, District 4 - Northern",1743,29
Clayton,Advance in Person,25878,"Public Service Commission, District 4 - Northern",25808,70
Clayton,Election Day,34794,"Public Service Commission, District 4 - Northern",34664,130
Clayton,Provisional,66,"Public Service Commission, District 4 - Northern",64,2
Clinch,Absentee by Mail,53,"Public Service Commission, District 4 - Northern",52,1
Clinch,Advance in Person,340,"Public Service Commission, District 4 - Northern",336,4
Clinch,Election Day,777,"Public Service Commission, District 4 - Northern",767,10
Clinch,Provisional,2,"Public Service Commission, District 4 - Northern",2,0
Cobb,Absentee by Mail,10616,"Public Service Commission, District 4 - Northern",10205,411
Cobb,Advance in Person,58755,"Public Service Commission, District 4 - Northern",57615,1140
Cobb,Election Day,143123,"Public Service Commission, District 4 - Northern",139109,4014
Cobb,Provisional,581,"Public Service Commission, District 4 - Northern",558,23
Coffee,Absentee by Mail,328,"Public Service Commission, District 4 - Northern",321,7
Coffee,Advance in Person,3477,"Public Service Commission, District 4 - Northern",3446,31
Coffee,Election Day,4390,"Public Service Commission, District 4 - Northern",4327,63
Coffee,Provisional,7,"Public Service Commission, District 4 - Northern",7,0
Colquitt,Absentee by Mail,172,"Public Service Commission, District 4 - Northern",168,4
Colquitt,Advance in Person,2409,"Public Service Commission, District 4 - Northern",2393,16
Colquitt,Election Day,5359,"Public Service Commission, District 4 - Northern",5313,46
Colquitt,Provisional,4,"Public Service Commission, District 4 - Northern",4,0
Columbia,Absentee by Mail,1698,"Public Service Commission, District 4 - Northern",1646,52
Columbia,Advance in Person,11710,"Public Service Commission, District 4 - Northern",11648,62
Columbia,Election Day,26403,"Public Service Commission, District 4 - Northern",26263,140
Columbia,Provisional,10,"Public Service Commission, District 4 - Northern",10,0
Cook,Absentee by Mail,113,"Public Service Commission, District 4 - Northern",113,0
Cook,Advance in Person,1115,"Public Service Commission, District 4 - Northern",1109,6
Cook,Election Day,2316,"Public Service Commission, District 4 - Northern",2300,16
Cook,Provisional,0,"Public Service Commission, District 4 - Northern",0,0
Coweta,Absentee by Mail,1733,"Public Service Commission, District 4 - Northern",1684,49
Coweta,Advance in Person,9167,"Public Service Commission, District 4 - Northern",9086,81
Coweta,Election Day,26256,"Public Service Commission, District 4 - Northern",26005,251
Coweta,Provisional,15,"Public Service Commission, District 4 - Northern",15,0
Crawford,Absentee by Mail,146,"Public Service Commission, District 4 - Northern",142,4
Crawford,Advance in Person,1092,"Public Service Commission, District 4 - Northern",1073,19
Crawford,Election Day,2012,"Public Service Commission, District 4 - Northern",1996,16
Crawford,Provisional,4,"Public Service Commission, District 4 - Northern",4,0
Crisp,Absentee by Mail,169,"Public Service Commission, District 4 - Northern",164,5
Crisp,Advance in Person,2060,"Public Service Commission, District 4 - Northern",2029,31
Crisp,Election Day,2752,"Public Service Commission, District 4 - Northern",2706,46
Crisp,Provisional,2,"Public Service Commission, District 4 - Northern",2,0
Dade,Absentee by Mail,114,"Public Service Commission, District 4 - Northern",102,12
Dade,Advance in Person,1030,"Public Service Commission, District 4 - Northern",989,41
Dade,Election Day,2283,"Public Service Commission, District 4 - Northern",2202,81
Dade,Provisional,9,"Public Service Commission, District 4 - Northern",9,0
Dawson,Absentee by Mail,311,"Public Service Commission, District 4 - Northern",299,12
Dawson,Advance in Person,3231,"Public Service Commission, District 4 - Northern",3171,60
Dawson,Election Day,3731,"Public Service Commission, District 4 - Northern",3660,71
Dawson,Provisional,11,"Public Service Commission, District 4 - Northern",10,1
DeKalb,Absentee by Mail,8280,"Public Service Commission, District 4 - Northern",7895,385
DeKalb,Advance in Person,72480,"Public Service Commission, District 4 - Northern",71455,1025
DeKalb,Election Day,129376,"Public Service Commission, District 4 - Northern",125714,3662
DeKalb,Provisional,503,"Public Service Commission, District 4 - Northern",482,21
Decatur,Absentee by Mail,269,"Public Service Commission, District 4 - Northern",265,4
Decatur,Advance in Person,1985,"Public Service Commission, District 4 - Northern",1985,0
Decatur,Election Day,3820,"Public Service Commission, District 4 - Northern",3797,23
Decatur,Provisional,5,"Public Service Commission, District 4 - Northern",5,0
Dodge,Absentee by Mail,219,"Public Service Commission, District 4 - Northern",208,11
Dodge,Advance in Person,1690,"Public Service Commission, District 4 - Northern",1648,42
Dodge,Election Day,3173,"Public Service Commission, District 4 - Northern",3077,96
Dodge,Provisional,0,"Public Service Commission, District 4 - Northern",0,0
Dooly,Absentee by Mail,68,"Public Service Commission, District 4 - Northern",66,2
Dooly,Advance in Person,834,"Public Service Commission, District 4 - Northern",796,38
Dooly,Election Day,1783,"Public Service Commission, District 4 - Northern",1753,30
Dooly,Provisional,0,"Public Service Commission, District 4 - Northern",0,0
Dougherty,Absentee by Mail,1050,"Public Service Commission, District 4 - Northern",1016,34
Dougherty,Advance in Person,6272,"Public Service Commission, District 4 - Northern",6241,31
Dougherty,Election Day,16148,"Public Service Commission, District 4 - Northern",16075,73
Dougherty,Provisional,41,"Public Service Commission, District 4 - Northern",37,4
Douglas,Absentee by Mail,1308,"Public Service Commission, District 4 - Northern",1284,24
Douglas,Advance in Person,15797,"Public Service Commission, District 4 - Northern",15705,92
Douglas,Election Day,20398,"Public Service Commission, District 4 - Northern",20313,85
Douglas,Provisional,27,"Public Service Commission, District 4 - Northern",26,1
Early,Absentee by Mail,140,"Public Service Commission, District 4 - Northern",137,3
Early,Advance in Person,890,"Public Service Commission, District 4 - Northern",880,10
Early,Election Day,2163,"Public Service Commission, District 4 - Northern",2156,7
Early,Provisional,3,"Public Service Commission, District 4 - Northern",3,0
Echols,Absentee by Mail,19,"Public Service Commission, District 4 - Northern",19,0
Echols,Advance in Person,243,"Public Service Commission, District 4 - Northern",240,3
Echols,Election Day,361,"Public Service Commission, District 4 - Northern",353,8
Echols,Provisional,0,"Public Service Commission, District 4 - Northern",0,0
Effingham,Absentee by Mail,373,"Public Service Commission, District 4 - Northern",366,7
Effingham,Advance in Person,3036,"Public Service Commission, District 4 - Northern",3024,12
Effingham,Election Day,9204,"Public Service Commission, District 4 - Northern",9149,55
Effingham,Provisional,10,"Public Service Commission, District 4 - Northern",10,0
Elbert,Absentee by Mail,219,"Public Service Commission, District 4 - Northern",215,4
Elbert,Advance in Person,1841,"Public Service Commission, District 4 - Northern",1828,13
Elbert,Election Day,2632,"Public Service Commission, District 4 - Northern",2632,0
Elbert,Provisional,11,"Public Service Commission, District 4 - Northern",11,0
Emanuel,Absentee by Mail,213,"Public Service Commission, District 4 - Northern",206,7
Emanuel,Advance in Person,1187,"Public Service Commission, District 4 - Northern",1165,22
Emanuel,Election Day,3581,"Public Service Commission, District 4 - Northern",3530,51
Emanuel,Provisional,1,"Public Service Commission, District 4 - Northern",1,0
Evans,Absentee by Mail,122,"Public Service Commission, District 4 - Northern",116,6
Evans,Advance in Person,921,"Public Service Commission, District 4 - Northern",910,11
Evans,Election Day,1107,"Public Service Commission, District 4 - Northern",1096,11
Evans,Provisional,0,"Public Service Commission, District 4 - Northern",0,0
Fannin,Absentee by Mail,417,"Public Service Commission, District 4 - Northern",404,13
Fannin,Advance in Person,2268,"Public Service Commission, District 4 - Northern",2217,51
Fannin,Election Day,4216,"Public Service Commission, District 4 - Northern",4124,92
Fannin,Provisional,3,"Public Service Commission, District 4 - Northern",2,1
Fayette,Absentee by Mail,1272,"Public Service Commission, District 4 - Northern",1225,47
Fayette,Advance in Person,18189,"Public Service Commission, District 4 - Northern",17919,270
Fayette,Election Day,22606,"Public Service Commission, District 4 - Northern",22144,462
Fayette,Provisional,13,"Public Service Commission, District 4 - Northern",10,3
Floyd,Absentee by Mail,771,"Public Service Commission, District 4 - Northern",741,30
Floyd,Advance in Person,5763,"Public Service Commission, District 4 - Northern",5708,55
Floyd,Election Day,14210,"Public Service Commission, District 4 - Northern",13999,211
Floyd,Provisional,78,"Public Service Commission, District 4 - Northern",74,4
Forsyth,Absentee by Mail,1655,"Public Service Commission, District 4 - Northern",1581,74
Forsyth,Advance in Person,22647,"Public Service Commission, District 4 - Northern",22342,305
Forsyth,Election Day,32220,"Public Service Commission, District 4 - Northern",31645,575
Forsyth,Provisional,48,"Public Service Commission, District 4 - Northern",46,2
Franklin,Absentee by Mail,198,"Public Service Commission, District 4 - Northern",189,9
Franklin,Advance in Person,1077,"Public Service Commission, District 4 - Northern",1076,1
Franklin,Election Day,3454,"Public Service Commission, District 4 - Northern",3443,11
Franklin,Provisional,1,"Public Service Commission, District 4 - Northern",1,0
Fulton,Absentee by Mail,8864,"Public Service Commission, District 4 - Northern",8461,403
Fulton,Advance in Person,87201,"Public Service Commission, District 4 - Northern",85639,1562
Fulton,Election Day,167468,"Public Service Commission, District 4 - Northern",162611,4857
Fulton,Provisional,2135,"Public Service Commission, District 4 - Northern",2038,97
Gilmer,Absentee by Mail,378,"Public Service Commission, District 4 - Northern",370,8
Gilmer,Advance in Person,2578,"Public Service Commission, District 4 - Northern",2523,55
Gilmer,Election Day,4854,"Public Service Commission, District 4 - Northern",4704,150
Gilmer,Provisional,16,"Public Service Commission, District 4 - Northern",16,0
Glascock,Absentee by Mail,36,"Public Service Commission, District 4 - Northern",32,4
Glascock,Advance in Person,211,"Public Service Commission, District 4 - Northern",205,6
Glascock,Election Day,542,"Public Service Commission, District 4 - Northern",538,4
Glascock,Provisional,0,"Public Service Commission, District 4 - Northern",0,0
Glynn,Absentee by Mail,883,"Public Service Commission, District 4 - Northern",871,12
Glynn,Advance in Person,7098,"Public Service Commission, District 4 - Northern",7060,38
Glynn,Election Day,12102,"Public Service Commission, District 4 - Northern",11994,108
Glynn,Provisional,36,"Public Service Commission, District 4 - Northern",34,2
Gordon,Absentee by Mail,370,"Public Service Commission, District 4 - Northern",353,17
Gordon,Advance in Person,2666,"Public Service Commission, District 4 - Northern",2586,80
Gordon,Election Day,7273,"Public Service Commission, District 4 - Northern",7059,214
Gordon,Provisional,16,"Public Service Commission, District 4 - Northern",14,2
Grady,Absentee by Mail,157,"Public Service Commission, District 4 - Northern",154,3
Grady,Advance in Person,1854,"Public Service Commission, District 4 - Northern",1847,7
Grady,Election Day,3548,"Public Service Commission, District 4 - Northern",3530,18
Grady,Provisional,6,"Public Service Commission, District 4 - Northern",6,0
Greene,Absentee by Mail,538,"Public Service Commission, District 4 - Northern",526,12
Greene,Advance in Person,3068,"Public Service Commission, District 4 - Northern",3043,25
Greene,Election Day,2907,"Public Service Commission, District 4 - Northern",2849,58
Greene,Provisional,10,"Public Service Commission, District 4 - Northern",10,0
Gwinnett,Absentee by Mail,8170,"Public Service Commission, District 4 - Northern",7885,285
Gwinnett,Advance in Person,47244,"Public Service Commission, District 4 - Northern",46869,375
Gwinnett,Election Day,141636,"Public Service Commission, District 4 - Northern",139392,2244
Gwinnett,Provisional,1155,"Public Service Commission, District 4 - Northern",1129,26
Habersham,Absentee by Mail,704,"Public Service Commission, District 4 - Northern",674,30
Habersham,Advance in Person,5381,"Public Service Commission, District 4 - Northern",5277,104
Habersham,Election Day,3529,"Public Service Commission, District 4 - Northern",3459,70
Habersham,Provisional,34,"Public Service Commission, District 4 - Northern",31,3
Hall,Absentee by Mail,2074,"Public Service Commission, District 4 - Northern",2008,66
Hall,Advance in Person,12299,"Public Service Commission, District 4 - Northern",12106,193
Hall,Election Day,29428,"Public Service Commission, District 4 - Northern",28924,504
Hall,Provisional,42,"Public Service Commission, District 4 - Northern",40,2
Hancock,Absentee by Mail,283,"Public Service Commission, District 4 - Northern",275,8
Hancock,Advance in Person,839,"Public Service Commission, District 4 - Northern",814,25
Hancock,Election Day,1257,"Public Service Commission, District 4 - Northern",1244,13
Hancock,Provisional,19,"Public Service Commission, District 4 - Northern",15,4
Haralson,Absentee by Mail,262,"Public Service Commission, District 4 - Northern",257,5
Haralson,Advance in Person,1563,"Public Service Commission, District 4 - Northern",1551,12
Haralson,Election Day,4986,"Public Service Commission, District 4 - Northern",4939,47
Haralson,Provisional,2,"Public Service Commission, District 4 - Northern",2,0
Harris,Absentee by Mail,493,"Public Service Commission, District 4 - Northern",480,13
Harris,Advance in Person,2950,"Public Service Commission, District 4 - Northern",2944,6
Harris,Election Day,6803,"Public Service Commission, District 4 - Northern",6770,33
Harris,Provisional,2,"Public Service Commission, District 4 - Northern",2,0
Hart,Absentee by Mail,287,"Public Service Commission, District 4 - Northern",278,9
Hart,Advance in Person,2309,"Public Service Commission, District 4 - Northern",2243,66
Hart,Election Day,4185,"Public Service Commission, District 4 - Northern",4132,53
Hart,Provisional,1,"Public Service Commission, District 4 - Northern",1,0
Heard,Absentee by Mail,157,"Public Service Commission, District 4 - Northern",153,4
Heard,Advance in Person,552,"Public Service Commission, District 4 - Northern",541,11
Heard,Election Day,1772,"Public Service Commission, District 4 - Northern",1745,27
Heard,Provisional,0,"Public Service Commission, District 4 - Northern",0,0
Henry,Absentee by Mail,2016,"Public Service Commission, District 4 - Northern",1983,33
Henry,Advance in Person,29231,"Public Service Commission, District 4 - Northern",29175,56
Henry,Election Day,31732,"Public Service Commission, District 4 - Northern",31536,196
Henry,Provisional,102,"Public Service Commission, District 4 - Northern",99,3
Houston,Absentee by Mail,1431,"Public Service Commission, District 4 - Northern",1397,34
Houston,Advance in Person,16400,"Public Service Commission, District 4 - Northern",16315,85
Houston,Election Day,19454,"Public Service Commission, District 4 - Northern",19278,176
Houston,Provisional,62,"Public Service Commission, District 4 - Northern",54,8
Irwin,Absentee by Mail,61,"Public Service Commission, District 4 - Northern",59,2
Irwin,Advance in Person,719,"Public Service Commission, District 4 - Northern",694,25
Irwin,Election Day,1581,"Public Service Commission, District 4 - Northern",1549,32
Irwin,Provisional,3,"Public Service Commission, District 4 - Northern",3,0
Jackson,Absentee by Mail,495,"Public Service Commission, District 4 - Northern",490,5
Jackson,Advance in Person,5419,"Public Service Commission, District 4 - Northern",5409,10
Jackson,Election Day,10060,"Public Service Commission, District 4 - Northern",9966,94
Jackson,Provisional,16,"Public Service Commission, District 4 - Northern",14,2
Jasper,Absentee by Mail,255,"Public Service Commission, District 4 - Northern",251,4
Jasper,Advance in Person,1280,"Public Service Commission, District 4 - Northern",1272,8
Jasper,Election Day,2305,"Public Service Commission, District 4 - Northern",2301,4
Jasper,Provisional,2,"Public Service Commission, District 4 - Northern",2,0
Jeff Davis,Absentee by Mail,153,"Public Service Commission, District 4 - Northern",146,7
Jeff Davis,Advance in Person,861,"Public Service Commission, District 4 - Northern",845,16
Jeff Davis,Election Day,1973,"Public Service Commission, District 4 - Northern",1921,52
Jeff Davis,Provisional,1,"Public Service Commission, District 4 - Northern",1,0
Jefferson,Absentee by Mail,216,"Public Service Commission, District 4 - Northern",215,1
Jefferson,Advance in Person,1158,"Public Service Commission, District 4 - Northern",1148,10
Jefferson,Election Day,3144,"Public Service Commission, District 4 - Northern",3125,19
Jefferson,Provisional,20,"Public Service Commission, District 4 - Northern",19,1
Jenkins,Absentee by Mail,163,"Public Service Commission, District 4 - Northern",160,3
Jenkins,Advance in Person,671,"Public Service Commission, District 4 - Northern",669,2
Jenkins,Election Day,1088,"Public Service Commission, District 4 - Northern",1078,10
Jenkins,Provisional,0,"Public Service Commission, District 4 - Northern",0,0
Johnson,Absentee by Mail,92,"Public Service Commission, District 4 - Northern",89,3
Johnson,Advance in Person,789,"Public Service Commission, District 4 - Northern",782,7
Johnson,Election Day,1415,"Public Service Commission, District 4 - Northern",1411,4
Johnson,Provisional,0,"Public Service Commission, District 4 - Northern",0,0
Jones,Absentee by Mail,511,"Public Service Commission, District 4 - Northern",502,9
Jones,Advance in Person,2913,"Public Service Commission, District 4 - Northern",2904,9
Jones,Election Day,4638,"Public Service Commission, District 4 - Northern",4619,19
Jones,Provisional,7,"Public Service Commission, District 4 - Northern",7,0
Lamar,Absentee by Mail,215,"Public Service Commission, District 4 - Northern",202,13
Lamar,Advance in Person,1700,"Public Service Commission, District 4 - Northern",1686,14
Lamar,Election Day,3046,"Public Service Commission, District 4 - Northern",3044,2
Lamar,Provisional,5,"Public Service Commission, District 4 - Northern",4,1
Lanier,Absentee by Mail,40,"Public Service Commission, District 4 - Northern",40,0
Lanier,Advance in Person,521,"Public Service Commission, District 4 - Northern",514,7
Lanier,Election Day,878,"Public Service Commission, District 4 - Northern",870,8
Lanier,Provisional,4,"Public Service Commission, District 4 - Northern",4,0
Laurens,Absentee by Mail,763,"Public Service Commission, District 4 - Northern",743,20
Laurens,Advance in Person,3953,"Public Service Commission, District 4 - Northern",3937,16
Laurens,Election Day,8153,"Public Service Commission, District 4 - Northern",8072,81
Laurens,Provisional,14,"Public Service Commission, District 4 - Northern",13,1
Lee,Absentee by Mail,241,"Public Service Commission, District 4 - Northern",233,8
Lee,Advance in Person,2107,"Public Service Commission, District 4 - Northern",2098,9
Lee,Election Day,6514,"Public Service Commission, District 4 - Northern",6480,34
Lee,Provisional,5,"Public Service Commission, District 4 - Northern",5,0
Liberty,Absentee by Mail,209,"Public Service Commission, District 4 - Northern",200,9
Liberty,Advance in Person,3652,"Public Service Commission, District 4 - Northern",3631,21
Liberty,Election Day,5097,"Public Service Commission, District 4 - Northern",5066,31
Liberty,Provisional,4,"Public Service Commission, District 4 - Northern",4,0
Lincoln,Absentee by Mail,222,"Public Service Commission, District 4 - Northern",216,6
Lincoln,Advance in Person,899,"Public Service Commission, District 4 - Northern",895,4
Lincoln,Election Day,1554,"Public Service Commission, District 4 - Northern",1530,24
Lincoln,Provisional,13,"Public Service Commission, District 4 - Northern",13,0
Long,Absentee by Mail,40,"Public Service Commission, District 4 - Northern",39,1
Long,Advance in Person,691,"Public Service Commission, District 4 - Northern",685,6
Long,Election Day,1397,"Public Service Commission, District 4 - Northern",1371,26
Long,Provisional,6,"Public Service Commission, District 4 - Northern",6,0
Lowndes,Absentee by Mail,532,"Public Service Commission, District 4 - Northern",514,18
Lowndes,Advance in Person,8813,"Public Service Commission, District 4 - Northern",8807,6
Lowndes,Election Day,11478,"Public Service Commission, District 4 - Northern",11415,63
Lowndes,Provisional,560,"Public Service Commission, District 4 - Northern",547,13
Lumpkin,Absentee by Mail,305,"Public Service Commission, District 4 - Northern",298,7
Lumpkin,Advance in Person,2933,"Public Service Commission, District 4 - Northern",2901,32
Lumpkin,Election Day,4404,"Public Service Commission, District 4 - Northern",4323,81
Lumpkin,Provisional,15,"Public Service Commission, District 4 - Northern",15,0
Macon,Absentee by Mail,106,"Public Service Commission, District 4 - Northern",101,5
Macon,Advance in Person,1207,"Public Service Commission, District 4 - Northern",1156,51
Macon,Election Day,1695,"Public Service Commission, District 4 - Northern",1644,51
Macon,Provisional,0,"Public Service Commission, District 4 - Northern",0,0
Madison,Absentee by Mail,312,"Public Service Commission, District 4 - Northern",303,9
Madison,Advance in Person,2257,"Public Service Commission, District 4 - Northern",2238,19
Madison,Election Day,4970,"Public Service Commission, District 4 - Northern",4877,93
Madison,Provisional,6,"Public Service Commission, District 4 - Northern",6,0
Marion,Absentee by Mail,219,"Public Service Commission, District 4 - Northern",213,6
Marion,Advance in Person,612,"Public Service Commission, District 4 - Northern",605,7
Marion,Election Day,1314,"Public Service Commission, District 4 - Northern",1286,28
Marion,Provisional,0,"Public Service Commission, District 4 - Northern",0,0
McDuffie,Absentee by Mail,351,"Public Service Commission, District 4 - Northern",344,7
McDuffie,Advance in Person,2043,"Public Service Commission, District 4 - Northern",2019,24
McDuffie,Election Day,3653,"Public Service Commission, District 4 - Northern",3619,34
McDuffie,Provisional,3,"Public Service Commission, District 4 - Northern",3,0
McIntosh,Absentee by Mail,300,"Public Service Commission, District 4 - Northern",290,10
McIntosh,Advance in Person,1300,"Public Service Commission, District 4 - Northern",1292,8
McIntosh,Election Day,2233,"Public Service Commission, District 4 - Northern",2200,33
McIntosh,Provisional,7,"Public Service Commission, District 4 - Northern",6,1
Meriwether,Absentee by Mail,207,"Public Service Commission, District 4 - Northern",201,6
Meriwether,Advance in Person,1188,"Public Service Commission, District 4 - Northern",1176,12
Meriwether,Election Day,4671,"Public Service Commission, District 4 - Northern",4592,79
Meriwether,Provisional,1,"Public Service Commission, District 4 - Northern",1,0
Miller,Absentee by Mail,53,"Public Service Commission, District 4 - Northern",49,4
Miller,Advance in Person,436,"Public Service Commission, District 4 - Northern",427,9
Miller,Election Day,937,"Public Service Commission, District 4 - Northern",923,14
Miller,Provisional,1,"Public Service Commission, District 4 - Northern",1,0
Mitchell,Absentee by Mail,202,"Public Service Commission, District 4 - Northern",196,6
Mitchell,Advance in Person,1589,"Public Service Commission, District 4 - Northern",1570,19
Mitchell,Election Day,3215,"Public Service Commission, District 4 - Northern",3215,0
Mitchell,Provisional,3,"Public Service Commission, District 4 - Northern",3,0
Monroe,Absentee by Mail,358,"Public Service Commission, District 4 - Northern",352,6
Monroe,Advance in Person,2523,"Public Service Commission, District 4 - Northern",2499,24
Monroe,Election Day,5671,"Public Service Commission, District 4 - Northern",5623,48
Monroe,Provisional,23,"Public Service Commission, District 4 - Northern",21,2
Montgomery,Absentee by Mail,92,"Public Service Commission, District 4 - Northern",86,6
Montgomery,Advance in Person,463,"Public Service Commission, District 4 - Northern",452,11
Montgomery,Election Day,1730,"Public Service Commission, District 4 - Northern",1710,20
Montgomery,Provisional,0,"Public Service Commission, District 4 - Northern",0,0
Morgan,Absentee by Mail,193,"Public Service Commission, District 4 - Northern",189,4
Morgan,Advance in Person,2475,"Public Service Commission, District 4 - Northern",2448,27
Morgan,Election Day,3635,"Public Service Commission, District 4 - Northern",3587,48
Morgan,Provisional,7,"Public Service Commission, District 4 - Northern",6,1
Murray,Absentee by Mail,207,"Public Service Commission, District 4 - Northern",192,15
Murray,Advance in Person,1347,"Public Service Commission, District 4 - Northern",1306,41
Murray,Election Day,4497,"Public Service Commission, District 4 - Northern",4386,111
Murray,Provisional,0,"Public Service Commission, District 4 - Northern",0,0
Muscogee,Absentee by Mail,2150,"Public Service Commission, District 4 - Northern",2089,61
Muscogee,Advance in Person,13494,"Public Service Commission, District 4 - Northern",13410,84
Muscogee,Election Day,25301,"Public Service Commission, District 4 - Northern",25166,135
Muscogee,Provisional,63,"Public Service Commission, District 4 - Northern",63,0
Newton,Absentee by Mail,1136,"Public Service Commission, District 4 - Northern",1100,36
Newton,Advance in Person,10430,"Public Service Commission, District 4 - Northern",10398,32
Newton,Election Day,16634,"Public Service Commission, District 4 - Northern",16576,58
Newton,Provisional,2,"Public Service Commission, District 4 - Northern",2,0
Oconee,Absentee by Mail,368,"Public Service Commission, District 4 - Northern",349,19
Oconee,Advance in Person,5438,"Public Service Commission, District 4 - Northern",5338,100
Oconee,Election Day,7726,"Public Service Commission, District 4 - Northern",7472,254
Oconee,Provisional,7,"Public Service Commission, District 4 - Northern",7,0
Oglethorpe,Absentee by Mail,217,"Public Service Commission, District 4 - Northern",210,7
Oglethorpe,Advance in Person,1609,"Public Service Commission, District 4 - Northern",1597,12
Oglethorpe,Election Day,2262,"Public Service Commission, District 4 - Northern",2238,24
Oglethorpe,Provisional,4,"Public Service Commission, District 4 - Northern",4,0
Paulding,Absentee by Mail,1789,"Public Service Commission, District 4 - Northern",1745,44
Paulding,Advance in Person,14824,"Public Service Commission, District 4 - Northern",14772,52
Paulding,Election Day,19620,"Public Service Commission, District 4 - Northern",19492,128
Paulding,Provisional,29,"Public Service Commission, District 4 - Northern",28,1
Peach,Absentee by Mail,215,"Public Service Commission, District 4 - Northern",208,7
Peach,Advance in Person,3402,"Public Service Commission, District 4 - Northern",3379,23
Peach,Election Day,3620,"Public Service Commission, District 4 - Northern",3611,9
Peach,Provisional,8,"Public Service Commission, District 4 - Northern",8,0
Pickens,Absentee by Mail,138,"Public Service Commission, District 4 - Northern",134,4
Pickens,Advance in Person,3653,"Public Service Commission, District 4 - Northern",3580,73
Pickens,Election Day,5031,"Public Service Commission, District 4 - Northern",4952,79
Pickens,Provisional,1,"Public Service Commission, District 4 - Northern",1,0
Pierce,Absentee by Mail,228,"Public Service Commission, District 4 - Northern",223,5
Pierce,Advance in Person,1629,"Public Service Commission, District 4 - Northern",1617,12
Pierce,Election Day,2106,"Public Service Commission, District 4 - Northern",2097,9
Pierce,Provisional,0,"Public Service Commission, District 4 - Northern",0,0
Pike,Absentee by Mail,246,"Public Service Commission, District 4 - Northern",233,13
Pike,Advance in Person,1650,"Public Service Commission, District 4 - Northern",1634,16
Pike,Election Day,3700,"Public Service Commission, District 4 - Northern",3667,33
Pike,Provisional,8,"Public Service Commission, District 4 - Northern",8,0
Polk,Absentee by Mail,235,"Public Service Commission, District 4 - Northern",230,5
Polk,Advance in Person,3214,"Public Service Commission, District 4 - Northern",3190,24
Polk,Election Day,4537,"Public Service Commission, District 4 - Northern",4474,63
Polk,Provisional,4,"Public Service Commission, District 4 - Northern",4,0
Pulaski,Absentee by Mail,86,"Public Service Commission, District 4 - Northern",82,4
Pulaski,Advance in Person,1249,"Public Service Commission, District 4 - Northern",1224,25
Pulaski,Election Day,1013,"Public Service Commission, District 4 - Northern",991,22
Pulaski,Provisional,2,"Public Service Commission, District 4 - Northern",2,0
Putnam,Absentee by Mail,387,"Public Service Commission, District 4 - Northern",375,12
Putnam,Advance in Person,2434,"Public Service Commission, District 4 - Northern",2413,21
Putnam,Election Day,3451,"Public Service Commission, District 4 - Northern",3429,22
Putnam,Provisional,2,"Public Service Commission, District 4 - Northern",2,0
Quitman,Absentee by Mail,41,"Public Service Commission, District 4 - Northern",41,0
Quitman,Advance in Person,209,"Public Service Commission, District 4 - Northern",208,1
Quitman,Election Day,347,"Public Service Commission, District 4 - Northern",345,2
Quitman,Provisional,1,"Public Service Commission, District 4 - Northern",1,0
Rabun,Absentee by Mail,427,"Public Service Commission, District 4 - Northern",406,21
Rabun,Advance in Person,3295,"Public Service Commission, District 4 - Northern",3192,103
Rabun,Election Day,1731,"Public Service Commission, District 4 - Northern",1657,74
Rabun,Provisional,0,"Public Service Commission, District 4 - Northern",0,0
Randolph,Absentee by Mail,149,"Public Service Commission, District 4 - Northern",140,9
Randolph,Advance in Person,789,"Public Service Commission, District 4 - Northern",773,16
Randolph,Election Day,1173,"Public Service Commission, District 4 - Northern",1157,16
Randolph,Provisional,7,"Public Service Commission, District 4 - Northern",7,0
Richmond,Absentee by Mail,3207,"Public Service Commission, District 4 - Northern",3139,68
Richmond,Advance in Person,13314,"Public Service Commission, District 4 - Northern",13232,82
Richmond,Election Day,31248,"Public Service Commission, District 4 - Northern",31059,189
Richmond,Provisional,71,"Public Service Commission, District 4 - Northern",71,0
Rockdale,Absentee by Mail,825,"Public Service Commission, District 4 - Northern",799,26
Rockdale,Advance in Person,13442,"Public Service Commission, District 4 - Northern",13364,78
Rockdale,Election Day,12256,"Public Service Commission, District 4 - Northern",12186,70
Rockdale,Provisional,48,"Public Service Commission, District 4 - Northern",48,0
Schley,Absentee by Mail,66,"Public Service Commission, District 4 - Northern",63,3
Schley,Advance in Person,602,"Public Service Commission, District 4 - Northern",596,6
Schley,Election Day,595,"Public Service Commission, District 4 - Northern",584,11
Schley,Provisional,3,"Public Service Commission, District 4 - Northern",2,1
Screven,Absentee by Mail,158,"Public Service Commission, District 4 - Northern",152,6
Screven,Advance in Person,1201,"Public Service Commission, District 4 - Northern",1182,19
Screven,Election Day,2412,"Public Service Commission, District 4 - Northern",2401,11
Screven,Provisional,4,"Public Service Commission, District 4 - Northern",4,0
Seminole,Absentee by Mail,76,"Public Service Commission, District 4 - Northern",74,2
Seminole,Advance in Person,477,"Public Service Commission, District 4 - Northern",474,3
Seminole,Election Day,1698,"Public Service Commission, District 4 - Northern",1677,21
Seminole,Provisional,5,"Public Service Commission, District 4 - Northern",5,0
Spalding,Absentee by Mail,528,"Public Service Commission, District 4 - Northern",509,19
Spalding,Advance in Person,6771,"Public Service Commission, District 4 - Northern",6677,94
Spalding,Election Day,9378,"Public Service Commission, District 4 - Northern",9293,85
Spalding,Provisional,14,"Public Service Commission, District 4 - Northern",14,0
Stephens,Absentee by Mail,337,"Public Service Commission, District 4 - Northern",328,9
Stephens,Advance in Person,2604,"Public Service Commission, District 4 - Northern",2581,23
Stephens,Election Day,2225,"Public Service Commission, District 4 - Northern",2216,9
Stephens,Provisional,2,"Public Service Commission, District 4 - Northern",2,0
Stewart,Absentee by Mail,75,"Public Service Commission, District 4 - Northern",69,6
Stewart,Advance in Person,311,"Public Service Commission, District 4 - Northern",285,26
Stewart,Election Day,808,"Public Service Commission, District 4 - Northern",773,35
Stewart,Provisional,18,"Public Service Commission, District 4 - Northern",18,0
Sumter,Absentee by Mail,522,"Public Service Commission, District 4 - Northern",515,7
Sumter,Advance in Person,3280,"Public Service Commission, District 4 - Northern",3242,38
Sumter,Election Day,4191,"Public Service Commission, District 4 - Northern",4131,60
Sumter,Provisional,5,"Public Service Commission, District 4 - Northern",5,0
Talbot,Absentee by Mail,215,"Public Service Commission, District 4 - Northern",201,14
Talbot,Advance in Person,342,"Public Service Commission, District 4 - Northern",339,3
Talbot,Election Day,1588,"Public Service Commission, District 4 - Northern",1556,32
Talbot,Provisional,2,"Public Service Commission, District 4 - Northern",2,0
Taliaferro,Absentee by Mail,50,"Public Service Commission, District 4 - Northern",48,2
Taliaferro,Advance in Person,197,"Public Service Commission, District 4 - Northern",193,4
Taliaferro,Election Day,311,"Public Service Commission, District 4 - Northern",308,3
Taliaferro,Provisional,0,"Public Service Commission, District 4 - Northern",0,0
Tattnall,Absentee by Mail,198,"Public Service Commission, District 4 - Northern",191,7
Tattnall,Advance in Person,1310,"Public Service Commission, District 4 - Northern",1278,32
Tattnall,Election Day,2706,"Public Service Commission, District 4 - Northern",2662,44
Tattnall,Provisional,6,"Public Service Commission, District 4 - Northern",6,0
Taylor,Absentee by Mail,127,"Public Service Commission, District 4 - Northern",125,2
Taylor,Advance in Person,620,"Public Service Commission, District 4 - Northern",611,9
Taylor,Election Day,1441,"Public Service Commission, District 4 - Northern",1429,12
Taylor,Provisional,0,"Public Service Commission, District 4 - Northern",0,0
Telfair,Absentee by Mail,227,"Public Service Commission, District 4 - Northern",226,1
Telfair,Advance in Person,751,"Public Service Commission, District 4 - Northern",724,27
Telfair,Election Day,1723,"Public Service Commission, District 4 - Northern",1695,28
Telfair,Provisional,0,"Public Service Commission, District 4 - Northern",0,0
Terrell,Absentee by Mail,258,"Public Service Commission, District 4 - Northern",238,20
Terrell,Advance in Person,1101,"Public Service Commission, District 4 - Northern",1076,25
Terrell,Election Day,1887,"Public Service Commission, District 4 - Northern",1867,20
Terrell,Provisional,2,"Public Service Commission, District 4 - Northern",2,0
Thomas,Absentee by Mail,293,"Public Service Commission, District 4 - Northern",281,12
Thomas,Advance in Person,3653,"Public Service Commission, District 4 - Northern",3645,8
Thomas,Election Day,7055,"Public Service Commission, District 4 - Northern",7031,24
Thomas,Provisional,2,"Public Service Commission, District 4 - Northern",2,0
Tift,Absentee by Mail,254,"Public Service Commission, District 4 - Northern",246,8
Tift,Advance in Person,3128,"Public Service Commission, District 4 - Northern",3103,25
Tift,Election Day,5030,"Public Service Commission, District 4 - Northern",4954,76
Tift,Provisional,92,"Public Service Commission, District 4 - Northern",85,7
Toombs,Absentee by Mail,381,"Public Service Commission, District 4 - Northern",361,20
Toombs,Advance in Person,1805,"Public Service Commission, District 4 - Northern",1780,25
Toombs,Election Day,3352,"Public Service Commission, District 4 - Northern",3326,26
Toombs,Provisional,6,"Public Service Commission, District 4 - Northern",5,1
Towns,Absentee by Mail,190,"Public Service Commission, District 4 - Northern",178,12
Towns,Advance in Person,2289,"Public Service Commission, District 4 - Northern",2242,47
Towns,Election Day,1717,"Public Service Commission, District 4 - Northern",1681,36
Towns,Provisional,68,"Public Service Commission, District 4 - Northern",64,4
Treutlen,Absentee by Mail,50,"Public Service Commission, District 4 - Northern",48,2
Treutlen,Advance in Person,426,"Public Service Commission, District 4 - Northern",421,5
Treutlen,Election Day,1041,"Public Service Commission, District 4 - Northern",1027,14
Treutlen,Provisional,3,"Public Service Commission, District 4 - Northern",3,0
Troup,Absentee by Mail,847,"Public Service Commission, District 4 - Northern",827,20
Troup,Advance in Person,4821,"Public Service Commission, District 4 - Northern",4800,21
Troup,Election Day,9963,"Public Service Commission, District 4 - Northern",9901,62
Troup,Provisional,41,"Public Service Commission, District 4 - Northern",39,2
Turner,Absentee by Mail,41,"Public Service Commission, District 4 - Northern",39,2
Turner,Advance in Person,1026,"Public Service Commission, District 4 - Northern",1011,15
Turner,Election Day,1188,"Public Service Commission, District 4 - Northern",1169,19
Turner,Provisional,11,"Public Service Commission, District 4 - Northern",11,0
Twiggs,Absentee by Mail,275,"Public Service Commission, District 4 - Northern",269,6
Twiggs,Advance in Person,841,"Public Service Commission, District 4 - Northern",835,6
Twiggs,Election Day,1776,"Public Service Commission, District 4 - Northern",1752,24
Twiggs,Provisional,1,"Public Service Commission, District 4 - Northern",1,0
Union,Absentee by Mail,288,"Public Service Commission, District 4 - Northern",271,17
Union,Advance in Person,3487,"Public Service Commission, District 4 - Northern",3421,66
Union,Election Day,3966,"Public Service Commission, District 4 - Northern",3867,99
Union,Provisional,2,"Public Service Commission, District 4 - Northern",2,0
Upson,Absentee by Mail,230,"Public Service Commission, District 4 - Northern",219,11
Upson,Advance in Person,2400,"Public Service Commission, District 4 - Northern",2383,17
Upson,Election Day,4440,"Public Service Commission, District 4 - Northern",4416,24
Upson,Provisional,1,"Public Service Commission, District 4 - Northern",1,0
Walker,Absentee by Mail,617,"Public Service Commission, District 4 - Northern",601,16
Walker,Advance in Person,3646,"Public Service Commission, District 4 - Northern",3617,29
Walker,Election Day,8076,"Public Service Commission, District 4 - Northern",7995,81
Walker,Provisional,0,"Public Service Commission, District 4 - Northern",0,0
Walton,Absentee by Mail,1068,"Public Service Commission, District 4 - Northern",1027,41
Walton,Advance in Person,6096,"Public Service Commission, District 4 - Northern",6051,45
Walton,Election Day,18659,"Public Service Commission, District 4 - Northern",18441,218
Walton,Provisional,16,"Public Service Commission, District 4 - Northern",16,0
Ware,Absentee by Mail,326,"Public Service Commission, District 4 - Northern",319,7
Ware,Advance in Person,2081,"Public Service Commission, District 4 - Northern",2060,21
Ware,Election Day,4306,"Public Service Commission, District 4 - Northern",4284,22
Ware,Provisional,1,"Public Service Commission, District 4 - Northern",1,0
Warren,Absentee by Mail,60,"Public Service Commission, District 4 - Northern",60,0
Warren,Advance in Person,543,"Public Service Commission, District 4 - Northern",533,10
Warren,Election Day,889,"Public Service Commission, District 4 - Northern",886,3
Warren,Provisional,1,"Public Service Commission, District 4 - Northern",1,0
Washington,Absentee by Mail,355,"Public Service Commission, District 4 - Northern",343,12
Washington,Advance in Person,2324,"Public Service Commission, District 4 - Northern",2269,55
Washington,Election Day,3362,"Public Service Commission, District 4 - Northern",3280,82
Washington,Provisional,8,"Public Service Commission, District 4 - Northern",8,0
Wayne,Absentee by Mail,258,"Public Service Commission, District 4 - Northern",245,13
Wayne,Advance in Person,2152,"Public Service Commission, District 4 - Northern",2127,25
Wayne,Election Day,3740,"Public Service Commission, District 4 - Northern",3692,48
Wayne,Provisional,0,"Public Service Commission, District 4 - Northern",0,0
Webster,Absentee by Mail,80,"Public Service Commission, District 4 - Northern",78,2
Webster,Advance in Person,271,"Public Service Commission, District 4 - Northern",263,8
Webster,Election Day,426,"Public Service Commission, District 4 - Northern",417,9
Webster,Provisional,0,"Public Service Commission, District 4 - Northern",0,0
Wheeler,Absentee by Mail,87,"Public Service Commission, District 4 - Northern",85,2
Wheeler,Advance in Person,447,"Public Service Commission, District 4 - Northern",431,16
Wheeler,Election Day,959,"Public Service Commission, District 4 - Northern",950,9
Wheeler,Provisional,9,"Public Service Commission, District 4 - Northern",8,1
White,Absentee by Mail,447,"Public Service Commission, District 4 - Northern",437,10
White,Advance in Person,2267,"Public Service Commission, District 4 - Northern",2248,19
White,Election Day,4948,"Public Service Commission, District 4 - Northern",4852,96
White,Provisional,3,"Public Service Commission, District 4 - Northern",3,0
Whitfield,Absentee by Mail,478,"Public Service Commission, District 4 - Northern",461,17
Whitfield,Advance in Person,3511,"Public Service Commission, District 4 - Northern",3452,59
Whitfield,Election Day,11767,"Public Service Commission, District 4 - Northern",11560,207
Whitfield,Provisional,38,"Public Service Commission, District 4 - Northern",38,0
Wilcox,Absentee by Mail,144,"Public Service Commission, District 4 - Northern",143,1
Wilcox,Advance in Person,455,"Public Service Commission, District 4 - Northern",452,3
Wilcox,Election Day,1280,"Public Service Commission, District 4 - Northern",1268,12
Wilcox,Provisional,3,"Public Service Commission, District 4 - Northern",3,0
Wilkes,Absentee by Mail,104,"Public Service Commission, District 4 - Northern",100,4
Wilkes,Advance in Person,939,"Public Service Commission, District 4 - Northern",939,0
Wilkes,Election Day,2044,"Public Service Commission, District 4 - Northern",2028,16
Wilkes,Provisional,3,"Public Service Commission, District 4 - Northern",3,0
Wilkinson,Absentee by Mail,150,"Public Service Commission, District 4 - Northern",145,5
Wilkinson,Advance in Person,763,"Public Service Commission, District 4 - Northern",744,19
Wilkinson,Election Day,2227,"Public Service Commission, District 4 - Northern",2192,35
Wilkinson,Provisional,1,"Public Service Commission, District 4 - Northern",1,0
Worth,Absentee by Mail,138,"Public Service Commission, District 4 - Northern",136,2
Worth,Advance in Person,1170,"Public Service Commission, District 4 - Northern",1162,8
Worth,Election Day,3871,"Public Service Commission, District 4 - Northern",3860,11
Worth,Provisional,10,"Public Service Commission, District 4 - Northern",10,0
