County,Vote type,Total ballots,Contest,Ballots cast,Undervotes
Appling,Absentee by Mail,530,Lieutenant Governor,523,7
Appling,Advance in Person,3298,Lieutenant Governor,3092,206
Appling,Election Day,2978,Lieutenant Governor,2768,210
Appling,Provisional,3,Lieutenant Governor,3,0
Atkinson,Absentee by Mail,88,Lieutenant Governor,88,0
Atkinson,Advance in Person,1285,Lieutenant Governor,1186,99
Atkinson,Election Day,1147,Lieutenant Governor,1028,119
Atkinson,Provisional,2,Lieutenant Governor,2,0
Bacon,Absentee by Mail,174,Lieutenant Governor,172,2
Bacon,Advance in Person,2828,Lieutenant Governor,2669,159
Bacon,Election Day,827,Lieutenant Governor,744,83
Bacon,Provisional,1,Lieutenant Governor,1,0
Baker,Absentee by Mail,141,Lieutenant Governor,135,6
Baker,Advance in Person,485,Lieutenant Governor,448,37
Baker,Election Day,665,Lieutenant Governor,607,58
Baker,Provisional,2,Lieutenant Governor,2,0
Baldwin,Absentee by Mail,1158,Lieutenant Governor,1148,10
Baldwin,Advance in Person,8295,Lieutenant Governor,7845,450
Baldwin,Election Day,6180,Lieutenant Governor,5748,432
Baldwin,Provisional,3,Lieutenant Governor,3,0
Banks,Absentee by Mail,223,Lieutenant Governor,222,1
Banks,Advance in Person,2771,Lieutenant Governor,2677,94
Banks,Election Day,3858,Lieutenant Governor,3733,125
Banks,Provisional,1,Lieutenant Governor,1,0
Barrow,Absentee by Mail,1263,Lieutenant Governor,1252,11
Barrow,Advance in Person,12223,Lieutenant Governor,11710,513
Barrow,Election Day,13912,Lieutenant Governor,13376,536
Barrow,Provisional,7,Lieutenant Governor,7,0
Bartow,Absentee by Mail,1568,Lieutenant Governor,1566,2
Bartow,Advance in Person,16175,Lieutenant Governor,16004,171
Bartow,Election Day,19584,Lieutenant Governor,19279,305
Bartow,Provisional,32,Lieutenant Governor,31,1
Ben Hill,Absentee by Mail,320,Lieutenant Governor,317,3
Ben Hill,Advance in Person,3605,Lieutenant Governor,3400,205
Ben Hill,Election Day,1608,Lieutenant Governor,1481,127
Ben Hill,Provisional,14,Lieutenant Governor,14,0
Berrien,Absentee by Mail,322,Lieutenant Governor,322,0
Berrien,Advance in Person,3153,Lieutenant Governor,3007,146
Berrien,Election Day,2772,Lieutenant Governor,2598,174
Berrien,Provisional,5,Lieutenant Governor,4,1
Bibb,Absentee by Mail,4461,Lieutenant Governor,4426,35
Bibb,Advance in Person,26183,Lieutenant Governor,24704,1479
Bibb,Election Day,29816,Lieutenant Governor,28281,1535
Bibb,Provisional,232,Lieutenant Governor,228,4
Bleckley,Absentee by Mail,257,Lieutenant Governor,255,2
Bleckley,Advance in Person,2805,Lieutenant Governor,2684,121
Bleckley,Election Day,1793,Lieutenant Governor,1702,91
Bleckley,Provisional,5,Lieutenant Governor,5,0
Brantley,Absentee by Mail,188,Lieutenant Governor,187,1
Brantley,Advance in Person,2868,Lieutenant Governor,2772,96
Brantley,Election Day,2633,Lieutenant Governor,2438,195
Brantley,Provisional,5,Lieutenant Governor,5,0
Brooks,Absentee by Mail,465,Lieutenant Governor,456,9
Brooks,Advance in Person,2417,Lieutenant Governor,2273,144
Brooks,Election Day,2814,Lieutenant Governor,2614,200
Brooks,Provisional,27,Lieutenant Governor,27,0
Bryan,Absentee by Mail,582,Lieutenant Governor,579,3
Bryan,Advance in Person,8342,Lieutenant Governor,8072,270
Bryan,Election Day,6046,Lieutenant Governor,5776,270
Bryan,Provisional,15,Lieutenant Governor,15,0
Bulloch,Absentee by Mail,1076,Lieutenant Governor,1060,16
Bulloch,Advance in Person,11170,Lieutenant Governor,10679,491
Bulloch,Election Day,11297,Lieutenant Governor,10816,481
Bulloch,Provisional,140,Lieutenant Governor,134,6
Burke,Absentee by Mail,968,Lieutenant Governor,965,3
Burke,Advance in Person,3199,Lieutenant Governor,3013,186
Burke,Election Day,4552,Lieutenant Governor,4258,294
Burke,Provisional,2,Lieutenant Governor,2,0
Butts,Absentee by Mail,380,Lieutenant Governor,377,3
Butts,Advance in Person,6277,Lieutenant Governor,6027,250
Butts,Election Day,2206,Lieutenant Governor,2104,102
Butts,Provisional,0,Lieutenant Governor,0,0
Calhoun,Absentee by Mail,185,Lieutenant Governor,183,2
Calhoun,Advance in Person,607,Lieutenant Governor,573,34
Calhoun,Election Day,1107,Lieutenant Governor,1027,80
Calhoun,Provisional,0,Lieutenant Governor,0,0
Camden,Absentee by Mail,1193,Lieutenant Governor,1184,9
Camden,Advance in Person,8085,Lieutenant Governor,7818,267
Camden,Election Day,7775,Lieutenant Governor,7420,355
Camden,Provisional,8,Lieutenant Governor,8,0
Candler,Absentee by Mail,120,Lieutenant Governor,118,2
Candler,Advance in Person,2335,Lieutenant Governor,2220,115
Candler,Election Day,1083,Lieutenant Governor,1019,64
Candler,Provisional,1,Lieutenant Governor,1,0
Carroll,Absentee by Mail,1518,Lieutenant Governor,1511,7
Carroll,Advance in Person,20100,Lieutenant Governor,19356,744
Carroll,Election Day,20121,Lieutenant Governor,19324,797
Carroll,Provisional,104,Lieutenant Governor,103,1
Catoosa,Absentee by Mail,540,Lieutenant Governor,537,3
Catoosa,Advance in Person,13673,Lieutenant Governor,13161,512
Catoosa,Election Day,9512,Lieutenant Governor,9137,375
Catoosa,Provisional,33,Lieutenant Governor,33,0
Charlton,Absentee by Mail,163,Lieutenant Governor,163,0
Charlton,Advance in Person,1549,Lieutenant Governor,1458,91
Charlton,Election Day,1657,Lieutenant Governor,1557,100
Charlton,Provisional,8,Lieutenant Governor,8,0
Chatham,Absentee by Mail,6177,Lieutenant Governor,6103,74
Chatham,Advance in Person,32338,Lieutenant Governor,30949,1389
Chatham,Election Day,64823,Lieutenant Governor,61477,3346
Chatham,Provisional,205,Lieutenant Governor,203,2
Chattahoochee,Absentee by Mail,35,Lieutenant Governor,35,0
Chattahoochee,Advance in Person,493,Lieutenant Governor,458,35
Chattahoochee,Election Day,574,Lieutenant Governor,544,30
Chattahoochee,Provisional,3,Lieutenant Governor,3,0
Chattooga,Absentee by Mail,225,Lieutenant Governor,223,2
Chattooga,Advance in Person,3452,Lieutenant Governor,3327,125
Chattooga,Election Day,3750,Lieutenant Governor,3564,186
Chattooga,Provisional,7,Lieutenant Governor,7,0
Cherokee,Absentee by Mail,5312,Lieutenant Governor,5281,31
Cherokee,Advance in Person,48565,Lieutenant Governor,47390,1175
Cherokee,Election Day,52422,Lieutenant Governor,50839,1583
Cherokee,Provisional,112,Lieutenant Governor,111,1
Clarke,Absentee by Mail,3022,Lieutenant Governor,2990,32
Clarke,Advance in Person,19957,Lieutenant Governor,19255,702
Clarke,Election Day,20282,Lieutenant Governor,19361,921
Clarke,Provisional,41,Lieutenant Governor,40,1
Clay,Absentee by Mail,143,Lieutenant Governor,140,3
Clay,Advance in Person,579,Lieutenant Governor,546,33
Clay,Election Day,464,Lieutenant Governor,425,39
Clay,Provisional,0,Lieutenant Governor,0,0
Clayton,Absentee by Mail,5847,Lieutenant Governor,5789,58
Clayton,Advance in Person,47671,Lieutenant Governor,45402,2269
Clayton,Election Day,38322,Lieutenant Governor,35928,2394
Clayton,Provisional,372,Lieutenant Governor,357,15
Clinch,Absentee by Mail,109,Lieutenant Governor,108,1
Clinch,Advance in Person,1236,Lieutenant Governor,1159,77
Clinch,Election Day,909,Lieutenant Governor,824,85
Clinch,Provisional,4,Lieutenant Governor,4,0
Cobb,Absentee by Mail,25901,Lieutenant Governor,25699,202
Cobb,Advance in Person,111554,Lieutenant Governor,108818,2736
Cobb,Election Day,172926,Lieutenant Governor,167944,4982
Cobb,Provisional,1433,Lieutenant Governor,1397,36
Coffee,Absentee by Mail,395,Lieutenant Governor,389,6
Coffee,Advance in Person,7664,Lieutenant Governor,7105,559
Coffee,Election Day,4536,Lieutenant Governor,4171,365
Coffee,Provisional,20,Lieutenant Governor,19,1
Colquitt,Absentee by Mail,514,Lieutenant Governor,511,3
Colquitt,Advance in Person,6071,Lieutenant Governor,5704,367
Colquitt,Election Day,6368,Lieutenant Governor,5919,449
Colquitt,Provisional,10,Lieutenant Governor,10,0
Columbia,Absentee by Mail,2936,Lieutenant Governor,2909,27
Columbia,Advance in Person,29686,Lieutenant Governor,28708,978
Columbia,Election Day,28969,Lieutenant Governor,28019,950
Columbia,Provisional,43,Lieutenant Governor,43,0
Cook,Absentee by Mail,244,Lieutenant Governor,241,3
Cook,Advance in Person,3069,Lieutenant Governor,2927,142
Cook,Election Day,2490,Lieutenant Governor,2350,140
Cook,Provisional,0,Lieutenant Governor,0,0
Coweta,Absentee by Mail,2812,Lieutenant Governor,2792,20
Coweta,Advance in Person,25641,Lieutenant Governor,24794,847
Coweta,Election Day,29603,Lieutenant Governor,28541,1062
Coweta,Provisional,15,Lieutenant Governor,15,0
Crawford,Absentee by Mail,234,Lieutenant Governor,230,4
Crawford,Advance in Person,2567,Lieutenant Governor,2402,165
Crawford,Election Day,2130,Lieutenant Governor,2036,94
Crawford,Provisional,3,Lieutenant Governor,3,0
Crisp,Absentee by Mail,363,Lieutenant Governor,359,4
Crisp,Advance in Person,4191,Lieutenant Governor,3973,218
Crisp,Election Day,2470,Lieutenant Governor,2258,212
Crisp,Provisional,26,Lieutenant Governor,24,2
Dade,Absentee by Mail,129,Lieutenant Governor,125,4
Dade,Advance in Person,2561,Lieutenant Governor,2437,124
Dade,Election Day,2760,Lieutenant Governor,2635,125
Dade,Provisional,12,Lieutenant Governor,12,0
Dawson,Absentee by Mail,439,Lieutenant Governor,436,3
Dawson,Advance in Person,7020,Lieutenant Governor,6802,218
Dawson,Election Day,4111,Lieutenant Governor,3965,146
Dawson,Provisional,11,Lieutenant Governor,11,0
DeKalb,Absentee by Mail,19672,Lieutenant Governor,19365,307
DeKalb,Advance in Person,150814,Lieutenant Governor,145179,5635
DeKalb,Election Day,140482,Lieutenant Governor,133659,6823
DeKalb,Provisional,1773,Lieutenant Governor,1730,43
Decatur,Absentee by Mail,548,Lieutenant Governor,547,1
Decatur,Advance in Person,4260,Lieutenant Governor,4027,233
Decatur,Election Day,4235,Lieutenant Governor,3971,264
Decatur,Provisional,103,Lieutenant Governor,101,2
Dodge,Absentee by Mail,448,Lieutenant Governor,439,9
Dodge,Advance in Person,3411,Lieutenant Governor,3187,224
Dodge,Election Day,3192,Lieutenant Governor,2948,244
Dodge,Provisional,10,Lieutenant Governor,10,0
Dooly,Absentee by Mail,196,Lieutenant Governor,192,4
Dooly,Advance in Person,1889,Lieutenant Governor,1731,158
Dooly,Election Day,1708,Lieutenant Governor,1558,150
Dooly,Provisional,2,Lieutenant Governor,1,1
Dougherty,Absentee by Mail,1944,Lieutenant Governor,1922,22
Dougherty,Advance in Person,11332,Lieutenant Governor,10501,831
Dougherty,Election Day,18021,Lieutenant Governor,16831,1190
Dougherty,Provisional,128,Lieutenant Governor,126,2
Douglas,Absentee by Mail,3233,Lieutenant Governor,3213,20
Douglas,Advance in Person,30219,Lieutenant Governor,29248,971
Douglas,Election Day,21745,Lieutenant Governor,20842,903
Douglas,Provisional,58,Lieutenant Governor,58,0
Early,Absentee by Mail,473,Lieutenant Governor,463,10
Early,Advance in Person,1569,Lieutenant Governor,1507,62
Early,Election Day,2089,Lieutenant Governor,1969,120
Early,Provisional,4,Lieutenant Governor,4,0
Echols,Absentee by Mail,35,Lieutenant Governor,35,0
Echols,Advance in Person,767,Lieutenant Governor,717,50
Echols,Election Day,341,Lieutenant Governor,319,22
Echols,Provisional,0,Lieutenant Governor,0,0
Effingham,Absentee by Mail,750,Lieutenant Governor,740,10
Effingham,Advance in Person,10717,Lieutenant Governor,10242,475
Effingham,Election Day,11898,Lieutenant Governor,11432,466
Effingham,Provisional,6,Lieutenant Governor,6,0
Elbert,Absentee by Mail,563,Lieutenant Governor,561,2
Elbert,Advance in Person,3722,Lieutenant Governor,3543,179
Elbert,Election Day,3034,Lieutenant Governor,2851,183
Elbert,Provisional,69,Lieutenant Governor,68,1
Emanuel,Absentee by Mail,390,Lieutenant Governor,382,8
Emanuel,Advance in Person,3424,Lieutenant Governor,3253,171
Emanuel,Election Day,3896,Lieutenant Governor,3592,304
Emanuel,Provisional,6,Lieutenant Governor,6,0
Evans,Absentee by Mail,199,Lieutenant Governor,197,2
Evans,Advance in Person,2162,Lieutenant Governor,2002,160
Evans,Election Day,1086,Lieutenant Governor,1025,61
Evans,Provisional,0,Lieutenant Governor,0,0
Fannin,Absentee by Mail,658,Lieutenant Governor,658,0
Fannin,Advance in Person,5341,Lieutenant Governor,5131,210
Fannin,Election Day,5204,Lieutenant Governor,4922,282
Fannin,Provisional,16,Lieutenant Governor,16,0
Fayette,Absentee by Mail,2647,Lieutenant Governor,2626,21
Fayette,Advance in Person,31073,Lieutenant Governor,30318,755
Fayette,Election Day,24242,Lieutenant Governor,23446,796
Fayette,Provisional,36,Lieutenant Governor,35,1
Floyd,Absentee by Mail,1260,Lieutenant Governor,1253,7
Floyd,Advance in Person,13688,Lieutenant Governor,13165,523
Floyd,Election Day,15277,Lieutenant Governor,14576,701
Floyd,Provisional,113,Lieutenant Governor,111,2
Forsyth,Absentee by Mail,4428,Lieutenant Governor,4399,29
Forsyth,Advance in Person,52559,Lieutenant Governor,51570,989
Forsyth,Election Day,36252,Lieutenant Governor,35280,972
Forsyth,Provisional,59,Lieutenant Governor,59,0
Franklin,Absentee by Mail,388,Lieutenant Governor,387,1
Franklin,Advance in Person,3502,Lieutenant Governor,3379,123
Franklin,Election Day,4259,Lieutenant Governor,4026,233
Franklin,Provisional,0,Lieutenant Governor,0,0
Fulton,Absentee by Mail,17842,Lieutenant Governor,17617,225
Fulton,Advance in Person,224522,Lieutenant Governor,216707,7815
Fulton,Election Day,179442,Lieutenant Governor,171285,8157
Fulton,Provisional,1982,Lieutenant Governor,1915,67
Gilmer,Absentee by Mail,559,Lieutenant Governor,559,0
Gilmer,Advance in Person,6295,Lieutenant Governor,6044,251
Gilmer,Election Day,5617,Lieutenant Governor,5403,214
Gilmer,Provisional,39,Lieutenant Governor,38,1
Glascock,Absentee by Mail,81,Lieutenant Governor,81,0
Glascock,Advance in Person,652,Lieutenant Governor,614,38
Glascock,Election Day,567,Lieutenant Governor,528,39
Glascock,Provisional,1,Lieutenant Governor,1,0
Glynn,Absentee by Mail,1812,Lieutenant Governor,1799,13
Glynn,Advance in Person,17510,Lieutenant Governor,16768,742
Glynn,Election Day,13179,Lieutenant Governor,12550,629
Glynn,Provisional,147,Lieutenant Governor,144,3
Gordon,Absentee by Mail,547,Lieutenant Governor,538,9
Gordon,Advance in Person,8119,Lieutenant Governor,7800,319
Gordon,Election Day,9106,Lieutenant Governor,8774,332
Gordon,Provisional,32,Lieutenant Governor,32,0
Grady,Absentee by Mail,400,Lieutenant Governor,398,2
Grady,Advance in Person,3857,Lieutenant Governor,3697,160
Grady,Election Day,4099,Lieutenant Governor,3879,220
Grady,Provisional,14,Lieutenant Governor,14,0
Greene,Absentee by Mail,623,Lieutenant Governor,615,8
Greene,Advance in Person,5593,Lieutenant Governor,5407,186
Greene,Election Day,2773,Lieutenant Governor,2584,189
Greene,Provisional,6,Lieutenant Governor,6,0
Gwinnett,Absentee by Mail,20397,Lieutenant Governor,20252,145
Gwinnett,Advance in Person,137166,Lieutenant Governor,132348,4818
Gwinnett,Election Day,155146,Lieutenant Governor,148451,6695
Gwinnett,Provisional,2209,Lieutenant Governor,2170,39
Habersham,Absentee by Mail,853,Lieutenant Governor,844,9
Habersham,Advance in Person,10023,Lieutenant Governor,9693,330
Habersham,Election Day,4619,Lieutenant Governor,4430,189
Habersham,Provisional,5,Lieutenant Governor,5,0
Hall,Absentee by Mail,3493,Lieutenant Governor,3476,17
Hall,Advance in Person,24348,Lieutenant Governor,23638,710
Hall,Election Day,39441,Lieutenant Governor,37804,1637
Hall,Provisional,124,Lieutenant Governor,119,5
Hancock,Absentee by Mail,490,Lieutenant Governor,474,16
Hancock,Advance in Person,1531,Lieutenant Governor,1396,135
Hancock,Election Day,1518,Lieutenant Governor,1358,160
Hancock,Provisional,9,Lieutenant Governor,8,1
Haralson,Absentee by Mail,393,Lieutenant Governor,392,1
Haralson,Advance in Person,4202,Lieutenant Governor,4060,142
Haralson,Election Day,5990,Lieutenant Governor,5746,244
Haralson,Provisional,0,Lieutenant Governor,0,0
Harris,Absentee by Mail,729,Lieutenant Governor,720,9
Harris,Advance in Person,7251,Lieutenant Governor,6966,285
Harris,Election Day,7992,Lieutenant Governor,7647,345
Harris,Provisional,14,Lieutenant Governor,14,0
Hart,Absentee by Mail,440,Lieutenant Governor,436,4
Hart,Advance in Person,5220,Lieutenant Governor,4962,258
Hart,Election Day,3958,Lieutenant Governor,3764,194
Hart,Provisional,4,Lieutenant Governor,4,0
Heard,Absentee by Mail,278,Lieutenant Governor,274,4
Heard,Advance in Person,1427,Lieutenant Governor,1364,63
Heard,Election Day,2346,Lieutenant Governor,2254,92
Heard,Provisional,4,Lieutenant Governor,4,0
Henry,Absentee by Mail,4997,Lieutenant Governor,4948,49
Henry,Advance in Person,58658,Lieutenant Governor,56079,2579
Henry,Election Day,34710,Lieutenant Governor,33245,1465
Henry,Provisional,193,Lieutenant Governor,189,4
Houston,Absentee by Mail,3190,Lieutenant Governor,3164,26
Houston,Advance in Person,34816,Lieutenant Governor,33378,1438
Houston,Election Day,21152,Lieutenant Governor,20284,868
Houston,Provisional,74,Lieutenant Governor,72,2
Irwin,Absentee by Mail,133,Lieutenant Governor,133,0
Irwin,Advance in Person,2048,Lieutenant Governor,1956,92
Irwin,Election Day,1375,Lieutenant Governor,1307,68
Irwin,Provisional,8,Lieutenant Governor,8,0
Jackson,Absentee by Mail,1019,Lieutenant Governor,1012,7
Jackson,Advance in Person,14919,Lieutenant Governor,14392,527
Jackson,Election Day,10951,Lieutenant Governor,10581,370
Jackson,Provisional,10,Lieutenant Governor,10,0
Jasper,Absentee by Mail,421,Lieutenant Governor,418,3
Jasper,Advance in Person,2981,Lieutenant Governor,2884,97
Jasper,Election Day,2505,Lieutenant Governor,2378,127
Jasper,Provisional,38,Lieutenant Governor,37,1
Jeff Davis,Absentee by Mail,229,Lieutenant Governor,226,3
Jeff Davis,Advance in Person,2680,Lieutenant Governor,2564,116
Jeff Davis,Election Day,1906,Lieutenant Governor,1824,82
Jeff Davis,Provisional,0,Lieutenant Governor,0,0
Jefferson,Absentee by Mail,607,Lieutenant Governor,598,9
Jefferson,Advance in Person,2803,Lieutenant Governor,2564,239
Jefferson,Election Day,3346,Lieutenant Governor,3054,292
Jefferson,Provisional,11,Lieutenant Governor,11,0
Jenkins,Absentee by Mail,188,Lieutenant Governor,181,7
Jenkins,Advance in Person,1557,Lieutenant Governor,1468,89
Jenkins,Election Day,1111,Lieutenant Governor,1042,69
Jenkins,Provisional,16,Lieutenant Governor,16,0
Johnson,Absentee by Mail,236,Lieutenant Governor,225,11
Johnson,Advance in Person,1970,Lieutenant Governor,1848,122
Johnson,Election Day,1277,Lieutenant Governor,1182,95
Johnson,Provisional,0,Lieutenant Governor,0,0
Jones,Absentee by Mail,784,Lieutenant Governor,773,11
Jones,Advance in Person,6968,Lieutenant Governor,6667,301
Jones,Election Day,4680,Lieutenant Governor,4498,182
Jones,Provisional,9,Lieutenant Governor,9,0
Lamar,Absentee by Mail,404,Lieutenant Governor,402,2
Lamar,Advance in Person,3820,Lieutenant Governor,3598,222
Lamar,Election Day,3122,Lieutenant Governor,2938,184
Lamar,Provisional,11,Lieutenant Governor,11,0
Lanier,Absentee by Mail,108,Lieutenant Governor,106,2
Lanier,Advance in Person,1661,Lieutenant Governor,1553,108
Lanier,Election Day,910,Lieutenant Governor,827,83
Lanier,Provisional,2,Lieutenant Governor,2,0
Laurens,Absentee by Mail,1286,Lieutenant Governor,1265,21
Laurens,Advance in Person,8485,Lieutenant Governor,7997,488
Laurens,Election Day,9168,Lieutenant Governor,8632,536
Laurens,Provisional,13,Lieutenant Governor,12,1
Lee,Absentee by Mail,480,Lieutenant Governor,473,7
Lee,Advance in Person,5681,Lieutenant Governor,5476,205
Lee,Election Day,7388,Lieutenant Governor,7064,324
Lee,Provisional,6,Lieutenant Governor,6,0
Liberty,Absentee by Mail,950,Lieutenant Governor,944,6
Liberty,Advance in Person,8143,Lieutenant Governor,7795,348
Liberty,Election Day,6265,Lieutenant Governor,5971,294
Liberty,Provisional,10,Lieutenant Governor,10,0
Lincoln,Absentee by Mail,350,Lieutenant Governor,347,3
Lincoln,Advance in Person,1937,Lieutenant Governor,1851,86
Lincoln,Election Day,1680,Lieutenant Governor,1589,91
Lincoln,Provisional,2,Lieutenant Governor,2,0
Long,Absentee by Mail,169,Lieutenant Governor,167,2
Long,Advance in Person,1971,Lieutenant Governor,1892,79
Long,Election Day,1848,Lieutenant Governor,1734,114
Long,Provisional,10,Lieutenant Governor,10,0
Lowndes,Absentee by Mail,1890,Lieutenant Governor,1865,25
Lowndes,Advance in Person,21238,Lieutenant Governor,20272,966
Lowndes,Election Day,12084,Lieutenant Governor,11498,586
Lowndes,Provisional,541,Lieutenant Governor,525,16
Lumpkin,Absentee by Mail,467,Lieutenant Governor,466,1
Lumpkin,Advance in Person,7377,Lieutenant Governor,7183,194
Lumpkin,Election Day,3707,Lieutenant Governor,3578,129
Lumpkin,Provisional,7,Lieutenant Governor,7,0
Macon,Absentee by Mail,331,Lieutenant Governor,327,4
Macon,Advance in Person,2251,Lieutenant Governor,2062,189
Macon,Election Day,1635,Lieutenant Governor,1494,141
Macon,Provisional,0,Lieutenant Governor,0,0
Madison,Absentee by Mail,527,Lieutenant Governor,523,4
Madison,Advance in Person,5242,Lieutenant Governor,5011,231
Madison,Election Day,5928,Lieutenant Governor,5647,281
Madison,Provisional,2,Lieutenant Governor,2,0
Marion,Absentee by Mail,241,Lieutenant Governor,239,2
Marion,Advance in Person,1222,Lieutenant Governor,1099,123
Marion,Election Day,1467,Lieutenant Governor,1373,94
Marion,Provisional,1,Lieutenant Governor,1,0
McDuffie,Absentee by Mail,868,Lieutenant Governor,858,10
McDuffie,Advance in Person,5045,Lieutenant Governor,4771,274
McDuffie,Election Day,2879,Lieutenant Governor,2699,180
McDuffie,Provisional,0,Lieutenant Governor,0,0
McIntosh,Absentee by Mail,440,Lieutenant Governor,434,6
McIntosh,Advance in Person,2945,Lieutenant Governor,2789,156
McIntosh,Election Day,2023,Lieutenant Governor,1901,122
McIntosh,Provisional,0,Lieutenant Governor,0,0
Meriwether,Absentee by Mail,483,Lieutenant Governor,481,2
Meriwether,Advance in Person,2831,Lieutenant Governor,2664,167
Meriwether,Election Day,5325,Lieutenant Governor,4998,327
Meriwether,Provisional,11,Lieutenant Governor,11,0
Miller,Absentee by Mail,132,Lieutenant Governor,128,4
Miller,Advance in Person,1029,Lieutenant Governor,960,69
Miller,Election Day,1152,Lieutenant Governor,1062,90
Miller,Provisional,2,Lieutenant Governor,2,0
Mitchell,Absentee by Mail,564,Lieutenant Governor,557,7
Mitchell,Advance in Person,3343,Lieutenant Governor,3092,251
Mitchell,Election Day,3539,Lieutenant Governor,3281,258
Mitchell,Provisional,9,Lieutenant Governor,9,0
Monroe,Absentee by Mail,696,Lieutenant Governor,696,0
Monroe,Advance in Person,6311,Lieutenant Governor,5997,314
Monroe,Election Day,5925,Lieutenant Governor,5618,307
Monroe,Provisional,10,Lieutenant Governor,10,0
Montgomery,Absentee by Mail,211,Lieutenant Governor,206,5
Montgomery,Advance in Person,1416,Lieutenant Governor,1371,45
Montgomery,Election Day,1901,Lieutenant Governor,1832,69
Montgomery,Provisional,0,Lieutenant Governor,0,0
Morgan,Absentee by Mail,410,Lieutenant Governor,403,7
Morgan,Advance in Person,5406,Lieutenant Governor,5161,245
Morgan,Election Day,3738,Lieutenant Governor,3592,146
Morgan,Provisional,4,Lieutenant Governor,4,0
Murray,Absentee by Mail,265,Lieutenant Governor,259,6
Murray,Advance in Person,5111,Lieutenant Governor,4828,283
Murray,Election Day,5715,Lieutenant Governor,5394,321
Murray,Provisional,0,Lieutenant Governor,0,0
Muscogee,Absentee by Mail,4422,Lieutenant Governor,4371,51
Muscogee,Advance in Person,27700,Lieutenant Governor,25692,2008
Muscogee,Election Day,31019,Lieutenant Governor,28984,2035
Muscogee,Provisional,131,Lieutenant Governor,131,0
Newton,Absentee by Mail,2735,Lieutenant Governor,2714,21
Newton,Advance in Person,19236,Lieutenant Governor,18359,877
Newton,Election Day,21158,Lieutenant Governor,20158,1000
Newton,Provisional,12,Lieutenant Governor,12,0
Oconee,Absentee by Mail,931,Lieutenant Governor,925,6
Oconee,Advance in Person,11688,Lieutenant Governor,11428,260
Oconee,Election Day,8114,Lieutenant Governor,7873,241
Oconee,Provisional,11,Lieutenant Governor,11,0
Oglethorpe,Absentee by Mail,409,Lieutenant Governor,405,4
Oglethorpe,Advance in Person,3417,Lieutenant Governor,3280,137
Oglethorpe,Election Day,2658,Lieutenant Governor,2507,151
Oglethorpe,Provisional,1,Lieutenant Governor,1,0
Paulding,Absentee by Mail,3307,Lieutenant Governor,3281,26
Paulding,Advance in Person,32842,Lieutenant Governor,31833,1009
Paulding,Election Day,25073,Lieutenant Governor,24076,997
Paulding,Provisional,83,Lieutenant Governor,81,2
Peach,Absentee by Mail,445,Lieutenant Governor,437,8
Peach,Advance in Person,6720,Lieutenant Governor,6378,342
Peach,Election Day,3190,Lieutenant Governor,3021,169
Peach,Provisional,90,Lieutenant Governor,86,4
Pickens,Absentee by Mail,222,Lieutenant Governor,221,1
Pickens,Advance in Person,7121,Lieutenant Governor,6930,191
Pickens,Election Day,6019,Lieutenant Governor,5760,259
Pickens,Provisional,0,Lieutenant Governor,0,0
Pierce,Absentee by Mail,327,Lieutenant Governor,326,1
Pierce,Advance in Person,4598,Lieutenant Governor,4420,178
Pierce,Election Day,1958,Lieutenant Governor,1843,115
Pierce,Provisional,1,Lieutenant Governor,1,0
Pike,Absentee by Mail,304,Lieutenant Governor,302,2
Pike,Advance in Person,4478,Lieutenant Governor,4338,140
Pike,Election Day,3752,Lieutenant Governor,3633,119
Pike,Provisional,9,Lieutenant Governor,9,0
Polk,Absentee by Mail,447,Lieutenant Governor,444,3
Polk,Advance in Person,7744,Lieutenant Governor,7322,422
Polk,Election Day,4668,Lieutenant Governor,4419,249
Polk,Provisional,2,Lieutenant Governor,2,0
Pulaski,Absentee by Mail,232,Lieutenant Governor,223,9
Pulaski,Advance in Person,2522,Lieutenant Governor,2356,166
Pulaski,Election Day,868,Lieutenant Governor,786,82
Pulaski,Provisional,0,Lieutenant Governor,0,0
Putnam,Absentee by Mail,598,Lieutenant Governor,595,3
Putnam,Advance in Person,4858,Lieutenant Governor,4718,140
Putnam,Election Day,3865,Lieutenant Governor,3709,156
Putnam,Provisional,14,Lieutenant Governor,14,0
Quitman,Absentee by Mail,60,Lieutenant Governor,53,7
Quitman,Advance in Person,451,Lieutenant Governor,408,43
Quitman,Election Day,429,Lieutenant Governor,379,50
Quitman,Provisional,0,Lieutenant Governor,0,0
Rabun,Absentee by Mail,843,Lieutenant Governor,834,9
Rabun,Advance in Person,4889,Lieutenant Governor,4726,163
Rabun,Election Day,1846,Lieutenant Governor,1769,77
Rabun,Provisional,0,Lieutenant Governor,0,0
Randolph,Absentee by Mail,313,Lieutenant Governor,308,5
Randolph,Advance in Person,1232,Lieutenant Governor,1131,101
Randolph,Election Day,1243,Lieutenant Governor,1130,113
Randolph,Provisional,1,Lieutenant Governor,1,0
Richmond,Absentee by Mail,5314,Lieutenant Governor,5255,59
Richmond,Advance in Person,28737,Lieutenant Governor,27187,1550
Richmond,Election Day,35992,Lieutenant Governor,34068,1924
Richmond,Provisional,112,Lieutenant Governor,111,1
Rockdale,Absentee by Mail,1853,Lieutenant Governor,1847,6
Rockdale,Advance in Person,22789,Lieutenant Governor,21988,801
Rockdale,Election Day,11958,Lieutenant Governor,11380,578
Rockdale,Provisional,55,Lieutenant Governor,53,2
Schley,Absentee by Mail,96,Lieutenant Governor,96,0
Schley,Advance in Person,1321,Lieutenant Governor,1277,44
Schley,Election Day,514,Lieutenant Governor,485,29
Schley,Provisional,2,Lieutenant Governor,2,0
Screven,Absentee by Mail,271,Lieutenant Governor,265,6
Screven,Advance in Person,2674,Lieutenant Governor,2517,157
Screven,Election Day,2462,Lieutenant Governor,2286,176
Screven,Provisional,7,Lieutenant Governor,7,0
Seminole,Absentee by Mail,264,Lieutenant Governor,258,6
Seminole,Advance in Person,1078,Lieutenant Governor,1023,55
Seminole,Election Day,1872,Lieutenant Governor,1776,96
Seminole,Provisional,13,Lieutenant Governor,12,1
Spalding,Absentee by Mail,1283,Lieutenant Governor,1265,18
Spalding,Advance in Person,13046,Lieutenant Governor,12447,599
Spalding,Election Day,10056,Lieutenant Governor,9518,538
Spalding,Provisional,32,Lieutenant Governor,30,2
Stephens,Absentee by Mail,536,Lieutenant Governor,526,10
Stephens,Advance in Person,6139,Lieutenant Governor,5928,211
Stephens,Election Day,2394,Lieutenant Governor,2293,101
Stephens,Provisional,18,Lieutenant Governor,17,1
Stewart,Absentee by Mail,233,Lieutenant Governor,230,3
Stewart,Advance in Person,694,Lieutenant Governor,604,90
Stewart,Election Day,857,Lieutenant Governor,743,114
Stewart,Provisional,35,Lieutenant Governor,35,0
Sumter,Absentee by Mail,877,Lieutenant Governor,862,15
Sumter,Advance in Person,5531,Lieutenant Governor,5272,259
Sumter,Election Day,4148,Lieutenant Governor,3896,252
Sumter,Provisional,0,Lieutenant Governor,0,0
Talbot,Absentee by Mail,285,Lieutenant Governor,267,18
Talbot,Advance in Person,772,Lieutenant Governor,716,56
Talbot,Election Day,1895,Lieutenant Governor,1721,174
Talbot,Provisional,2,Lieutenant Governor,2,0
Taliaferro,Absentee by Mail,162,Lieutenant Governor,151,11
Taliaferro,Advance in Person,441,Lieutenant Governor,379,62
Taliaferro,Election Day,314,Lieutenant Governor,275,39
Taliaferro,Provisional,4,Lieutenant Governor,4,0
Tattnall,Absentee by Mail,392,Lieutenant Governor,389,3
Tattnall,Advance in Person,3539,Lieutenant Governor,3346,193
Tattnall,Election Day,2708,Lieutenant Governor,2518,190
Tattnall,Provisional,8,Lieutenant Governor,8,0
Taylor,Absentee by Mail,243,Lieutenant Governor,242,1
Taylor,Advance in Person,1843,Lieutenant Governor,1740,103
Taylor,Election Day,1179,Lieutenant Governor,1086,93
Taylor,Provisional,29,Lieutenant Governor,29,0
Telfair,Absentee by Mail,331,Lieutenant Governor,329,2
Telfair,Advance in Person,1676,Lieutenant Governor,1568,108
Telfair,Election Day,1624,Lieutenant Governor,1499,125
Telfair,Provisional,1,Lieutenant Governor,1,0
Terrell,Absentee by Mail,327,Lieutenant Governor,321,6
Terrell,Advance in Person,1612,Lieutenant Governor,1519,93
Terrell,Election Day,1991,Lieutenant Governor,1851,140
Terrell,Provisional,9,Lieutenant Governor,9,0
Thomas,Absentee by Mail,991,Lieutenant Governor,986,5
Thomas,Advance in Person,8376,Lieutenant Governor,7885,491
Thomas,Election Day,7874,Lieutenant Governor,7435,439
Thomas,Provisional,3,Lieutenant Governor,3,0
Tift,Absentee by Mail,561,Lieutenant Governor,551,10
Tift,Advance in Person,7646,Lieutenant Governor,7213,433
Tift,Election Day,5462,Lieutenant Governor,5132,330
Tift,Provisional,4,Lieutenant Governor,3,1
Toombs,Absentee by Mail,681,Lieutenant Governor,671,10
Toombs,Advance in Person,4860,Lieutenant Governor,4647,213
Toombs,Election Day,3310,Lieutenant Governor,3145,165
Toombs,Provisional,9,Lieutenant Governor,9,0
Towns,Absentee by Mail,284,Lieutenant Governor,282,2
Towns,Advance in Person,4009,Lieutenant Governor,3873,136
Towns,Election Day,1839,Lieutenant Governor,1754,85
Towns,Provisional,0,Lieutenant Governor,0,0
Treutlen,Absentee by Mail,146,Lieutenant Governor,140,6
Treutlen,Advance in Person,1659,Lieutenant Governor,1582,77
Treutlen,Election Day,805,Lieutenant Governor,766,39
Treutlen,Provisional,4,Lieutenant Governor,4,0
Troup,Absentee by Mail,1264,Lieutenant Governor,1247,17
Troup,Advance in Person,11226,Lieutenant Governor,10723,503
Troup,Election Day,11173,Lieutenant Governor,10552,621
Troup,Provisional,250,Lieutenant Governor,245,5
Turner,Absentee by Mail,148,Lieutenant Governor,148,0
Turner,Advance in Person,1922,Lieutenant Governor,1747,175
Turner,Election Day,1199,Lieutenant Governor,1105,94
Turner,Provisional,5,Lieutenant Governor,5,0
Twiggs,Absentee by Mail,275,Lieutenant Governor,273,2
Twiggs,Advance in Person,1531,Lieutenant Governor,1409,122
Twiggs,Election Day,1981,Lieutenant Governor,1802,179
Twiggs,Provisional,5,Lieutenant Governor,5,0
Union,Absentee by Mail,482,Lieutenant Governor,478,4
Union,Advance in Person,6626,Lieutenant Governor,6407,219
Union,Election Day,4755,Lieutenant Governor,4572,183
Union,Provisional,2,Lieutenant Governor,2,0
Upson,Absentee by Mail,602,Lieutenant Governor,593,9
Upson,Advance in Person,6729,Lieutenant Governor,6363,366
Upson,Election Day,3227,Lieutenant Governor,3048,179
Upson,Provisional,10,Lieutenant Governor,10,0
Walker,Absentee by Mail,813,Lieutenant Governor,808,5
Walker,Advance in Person,11133,Lieutenant Governor,10546,587
Walker,Election Day,9505,Lieutenant Governor,8980,525
Walker,Provisional,39,Lieutenant Governor,38,1
Walton,Absentee by Mail,1769,Lieutenant Governor,1756,13
Walton,Advance in Person,14370,Lieutenant Governor,13788,582
Walton,Election Day,22496,Lieutenant Governor,21647,849
Walton,Provisional,51,Lieutenant Governor,50,1
Ware,Absentee by Mail,627,Lieutenant Governor,623,4
Ware,Advance in Person,5460,Lieutenant Governor,5189,271
Ware,Election Day,4917,Lieutenant Governor,4670,247
Ware,Provisional,12,Lieutenant Governor,12,0
Warren,Absentee by Mail,187,Lieutenant Governor,185,2
Warren,Advance in Person,1267,Lieutenant Governor,1181,86
Warren,Election Day,806,Lieutenant Governor,738,68
Warren,Provisional,1,Lieutenant Governor,1,0
Washington,Absentee by Mail,727,Lieutenant Governor,710,17
Washington,Advance in Person,3907,Lieutenant Governor,3628,279
Washington,Election Day,3525,Lieutenant Governor,3260,265
Washington,Provisional,10,Lieutenant Governor,10,0
Wayne,Absentee by Mail,501,Lieutenant Governor,500,1
Wayne,Advance in Person,5868,Lieutenant Governor,5630,238
Wayne,Election Day,3753,Lieutenant Governor,3562,191
Wayne,Provisional,10,Lieutenant Governor,8,2
Webster,Absentee by Mail,152,Lieutenant Governor,150,2
Webster,Advance in Person,544,Lieutenant Governor,517,27
Webster,Election Day,404,Lieutenant Governor,371,33
Webster,Provisional,0,Lieutenant Governor,0,0
Wheeler,Absentee by Mail,115,Lieutenant Governor,115,0
Wheeler,Advance in Person,974,Lieutenant Governor,916,58
Wheeler,Election Day,838,Lieutenant Governor,774,64
Wheeler,Provisional,4,Lieutenant Governor,4,0
White,Absentee by Mail,537,Lieutenant Governor,535,2
White,Advance in Person,5408,Lieutenant Governor,5238,170
White,Election Day,5489,Lieutenant Governor,5352,137
White,Provisional,6,Lieutenant Governor,5,1
Whitfield,Absentee by Mail,1017,Lieutenant Governor,1004,13
Whitfield,Advance in Person,9610,Lieutenant Governor,9126,484
Whitfield,Election Day,16675,Lieutenant Governor,15683,992
Whitfield,Provisional,25,Lieutenant Governor,24,1
Wilcox,Absentee by Mail,205,Lieutenant Governor,198,7
Wilcox,Advance in Person,1202,Lieutenant Governor,1140,62
Wilcox,Election Day,1408,Lieutenant Governor,1313,95
Wilcox,Provisional,0,Lieutenant Governor,0,0
Wilkes,Absentee by Mail,301,Lieutenant Governor,295,6
Wilkes,Advance in Person,2075,Lieutenant Governor,1944,131
Wilkes,Election Day,1995,Lieutenant Governor,1858,137
Wilkes,Provisional,6,Lieutenant Governor,6,0
Wilkinson,Absentee by Mail,270,Lieutenant Governor,268,2
Wilkinson,Advance in Person,1567,Lieutenant Governor,1477,90
Wilkinson,Election Day,2427,Lieutenant Governor,2238,189
Wilkinson,Provisional,1,Lieutenant Governor,1,0
Worth,Absentee by Mail,305,Lieutenant Governor,301,4
Worth,Advance in Person,3108,Lieutenant Governor,2936,172
Worth,Election Day,4418,Lieutenant Governor,4175,243
Worth,Provisional,15,Lieutenant Governor,15,0
Appling,Absentee by Mail,530,Secretary Of State,520,10
Appling,Advance in Person,3298,Secretary Of State,3233,65
Appling,Election Day,2978,Secretary Of State,2913,65
Appling,Provisional,3,Secretary Of State,3,0
Atkinson,Absentee by Mail,88,Secretary Of State,88,0
Atkinson,Advance in Person,1285,Secretary Of State,1240,45
Atkinson,Election Day,1147,Secretary Of State,1101,46
Atkinson,Provisional,2,Secretary Of State,1,1
Bacon,Absentee by Mail,174,Secretary Of State,171,3
Bacon,Advance in Person,2828,Secretary Of State,2767,61
Bacon,Election Day,827,Secretary Of State,790,37
Bacon,Provisional,1,Secretary Of State,1,0
Baker,Absentee by Mail,141,Secretary Of State,134,7
Baker,Advance in Person,485,Secretary Of State,466,19
Baker,Election Day,665,Secretary Of State,635,30
Baker,Provisional,2,Secretary Of State,2,0
Baldwin,Absentee by Mail,1158,Secretary Of State,1146,12
Baldwin,Advance in Person,8295,Secretary Of State,8133,162
Baldwin,Election Day,6180,Secretary Of State,6047,133
Baldwin,Provisional,3,Secretary Of State,3,0
Banks,Absentee by Mail,223,Secretary Of State,222,1
Banks,Advance in Person,2771,Secretary Of State,2724,47
Banks,Election Day,3858,Secretary Of State,3799,59
Banks,Provisional,1,Secretary Of State,1,0
Barrow,Absentee by Mail,1263,Secretary Of State,1249,14
Barrow,Advance in Person,12223,Secretary Of State,12105,118
Barrow,Election Day,13912,Secretary Of State,13759,153
Barrow,Provisional,7,Secretary Of State,7,0
Bartow,Absentee by Mail,1568,Secretary Of State,1556,12
Bartow,Advance in Person,16175,Secretary Of State,15915,260
Bartow,Election Day,19584,Secretary Of State,19222,362
Bartow,Provisional,32,Secretary Of State,31,1
Ben Hill,Absentee by Mail,320,Secretary Of State,317,3
Ben Hill,Advance in Person,3605,Secretary Of State,3549,56
Ben Hill,Election Day,1608,Secretary Of State,1580,28
Ben Hill,Provisional,14,Secretary Of State,13,1
Berrien,Absentee by Mail,322,Secretary Of State,317,5
Berrien,Advance in Person,3153,Secretary Of State,3085,68
Berrien,Election Day,2772,Secretary Of State,2716,56
Berrien,Provisional,5,Secretary Of State,4,1
Bibb,Absentee by Mail,4461,Secretary Of State,4430,31
Bibb,Advance in Person,26183,Secretary Of State,25758,425
Bibb,Election Day,29816,Secretary Of State,29375,441
Bibb,Provisional,232,Secretary Of State,228,4
Bleckley,Absentee by Mail,257,Secretary Of State,253,4
Bleckley,Advance in Person,2805,Secretary Of State,2736,69
Bleckley,Election Day,1793,Secretary Of State,1742,51
Bleckley,Provisional,5,Secretary Of State,5,0
Brantley,Absentee by Mail,188,Secretary Of State,186,2
Brantley,Advance in Person,2868,Secretary Of State,2811,57
Brantley,Election Day,2633,Secretary Of State,2566,67
Brantley,Provisional,5,Secretary Of State,5,0
Brooks,Absentee by Mail,465,Secretary Of State,454,11
Brooks,Advance in Person,2417,Secretary Of State,2366,51
Brooks,Election Day,2814,Secretary Of State,2722,92
Brooks,Provisional,27,Secretary Of State,27,0
Bryan,Absentee by Mail,582,Secretary Of State,578,4
Bryan,Advance in Person,8342,Secretary Of State,8271,71
Bryan,Election Day,6046,Secretary Of State,5964,82
Bryan,Provisional,15,Secretary Of State,15,0
Bulloch,Absentee by Mail,1076,Secretary Of State,1059,17
Bulloch,Advance in Person,11170,Secretary Of State,11061,109
Bulloch,Election Day,11297,Secretary Of State,11126,171
Bulloch,Provisional,140,Secretary Of State,136,4
Burke,Absentee by Mail,968,Secretary Of State,963,5
Burke,Advance in Person,3199,Secretary Of State,3167,32
Burke,Election Day,4552,Secretary Of State,4509,43
Burke,Provisional,2,Secretary Of State,2,0
Butts,Absentee by Mail,380,Secretary Of State,373,7
Butts,Advance in Person,6277,Secretary Of State,6164,113
Butts,Election Day,2206,Secretary Of State,2178,28
Butts,Provisional,0,Secretary Of State,0,0
Calhoun,Absentee by Mail,185,Secretary Of State,182,3
Calhoun,Advance in Person,607,Secretary Of State,592,15
Calhoun,Election Day,1107,Secretary Of State,1085,22
Calhoun,Provisional,0,Secretary Of State,0,0
Camden,Absentee by Mail,1193,Secretary Of State,1185,8
Camden,Advance in Person,8085,Secretary Of State,7988,97
Camden,Election Day,7775,Secretary Of State,7642,133
Camden,Provisional,8,Secretary Of State,8,0
Candler,Absentee by Mail,120,Secretary Of State,119,1
Candler,Advance in Person,2335,Secretary Of State,2297,38
Candler,Election Day,1083,Secretary Of State,1071,12
Candler,Provisional,1,Secretary Of State,1,0
Carroll,Absentee by Mail,1518,Secretary Of State,1505,13
Carroll,Advance in Person,20100,Secretary Of State,19856,244
Carroll,Election Day,20121,Secretary Of State,19870,251
Carroll,Provisional,104,Secretary Of State,100,4
Catoosa,Absentee by Mail,540,Secretary Of State,533,7
Catoosa,Advance in Person,13673,Secretary Of State,13467,206
Catoosa,Election Day,9512,Secretary Of State,9358,154
Catoosa,Provisional,33,Secretary Of State,33,0
Charlton,Absentee by Mail,163,Secretary Of State,159,4
Charlton,Advance in Person,1549,Secretary Of State,1533,16
Charlton,Election Day,1657,Secretary Of State,1598,59
Charlton,Provisional,8,Secretary Of State,8,0
Chatham,Absentee by Mail,6177,Secretary Of State,6062,115
Chatham,Advance in Person,32338,Secretary Of State,31924,414
Chatham,Election Day,64823,Secretary Of State,64019,804
Chatham,Provisional,205,Secretary Of State,203,2
Chattahoochee,Absentee by Mail,35,Secretary Of State,35,0
Chattahoochee,Advance in Person,493,Secretary Of State,477,16
Chattahoochee,Election Day,574,Secretary Of State,561,13
Chattahoochee,Provisional,3,Secretary Of State,3,0
Chattooga,Absentee by Mail,225,Secretary Of State,222,3
Chattooga,Advance in Person,3452,Secretary Of State,3374,78
Chattooga,Election Day,3750,Secretary Of State,3651,99
Chattooga,Provisional,7,Secretary Of State,7,0
Cherokee,Absentee by Mail,5312,Secretary Of State,5269,43
Cherokee,Advance in Person,48565,Secretary Of State,48145,420
Cherokee,Election Day,52422,Secretary Of State,51792,630
Cherokee,Provisional,112,Secretary Of State,108,4
Clarke,Absentee by Mail,3022,Secretary Of State,2973,49
Clarke,Advance in Person,19957,Secretary Of State,19758,199
Clarke,Election Day,20282,Secretary Of State,19927,355
Clarke,Provisional,41,Secretary Of State,40,1
Clay,Absentee by Mail,143,Secretary Of State,139,4
Clay,Advance in Person,579,Secretary Of State,563,16
Clay,Election Day,464,Secretary Of State,454,10
Clay,Provisional,0,Secretary Of State,0,0
Clayton,Absentee by Mail,5847,Secretary Of State,5767,80
Clayton,Advance in Person,47671,Secretary Of State,46996,675
Clayton,Election Day,38322,Secretary Of State,37743,579
Clayton,Provisional,372,Secretary Of State,359,13
Clinch,Absentee by Mail,109,Secretary Of State,108,1
Clinch,Advance in Person,1236,Secretary Of State,1184,52
Clinch,Election Day,909,Secretary Of State,875,34
Clinch,Provisional,4,Secretary Of State,4,0
Cobb,Absentee by Mail,25901,Secretary Of State,25588,313
Cobb,Advance in Person,111554,Secretary Of State,110717,837
Cobb,Election Day,172926,Secretary Of State,171114,1812
Cobb,Provisional,1433,Secretary Of State,1399,34
Coffee,Absentee by Mail,395,Secretary Of State,392,3
Coffee,Advance in Person,7664,Secretary Of State,7492,172
Coffee,Election Day,4536,Secretary Of State,4434,102
Coffee,Provisional,20,Secretary Of State,19,1
Colquitt,Absentee by Mail,514,Secretary Of State,509,5
Colquitt,Advance in Person,6071,Secretary Of State,5927,144
Colquitt,Election Day,6368,Secretary Of State,6202,166
Colquitt,Provisional,10,Secretary Of State,10,0
Columbia,Absentee by Mail,2936,Secretary Of State,2899,37
Columbia,Advance in Person,29686,Secretary Of State,29498,188
Columbia,Election Day,28969,Secretary Of State,28691,278
Columbia,Provisional,43,Secretary Of State,43,0
Cook,Absentee by Mail,244,Secretary Of State,242,2
Cook,Advance in Person,3069,Secretary Of State,3033,36
Cook,Election Day,2490,Secretary Of State,2453,37
Cook,Provisional,0,Secretary Of State,0,0
Coweta,Absentee by Mail,2812,Secretary Of State,2794,18
Coweta,Advance in Person,25641,Secretary Of State,25380,261
Coweta,Election Day,29603,Secretary Of State,29226,377
Coweta,Provisional,15,Secretary Of State,15,0
Crawford,Absentee by Mail,234,Secretary Of State,229,5
Crawford,Advance in Person,2567,Secretary Of State,2491,76
Crawford,Election Day,2130,Secretary Of State,2090,40
Crawford,Provisional,3,Secretary Of State,3,0
Crisp,Absentee by Mail,363,Secretary Of State,352,11
Crisp,Advance in Person,4191,Secretary Of State,4090,101
Crisp,Election Day,2470,Secretary Of State,2371,99
Crisp,Provisional,26,Secretary Of State,24,2
Dade,Absentee by Mail,129,Secretary Of State,123,6
Dade,Advance in Person,2561,Secretary Of State,2490,71
Dade,Election Day,2760,Secretary Of State,2678,82
Dade,Provisional,12,Secretary Of State,12,0
Dawson,Absentee by Mail,439,Secretary Of State,433,6
Dawson,Advance in Person,7020,Secretary Of State,6952,68
Dawson,Election Day,4111,Secretary Of State,4055,56
Dawson,Provisional,11,Secretary Of State,11,0
DeKalb,Absentee by Mail,19672,Secretary Of State,19274,398
DeKalb,Advance in Person,150814,Secretary Of State,148839,1975
DeKalb,Election Day,140482,Secretary Of State,138200,2282
DeKalb,Provisional,1773,Secretary Of State,1717,56
Decatur,Absentee by Mail,548,Secretary Of State,537,11
Decatur,Advance in Person,4260,Secretary Of State,4158,102
Decatur,Election Day,4235,Secretary Of State,4131,104
Decatur,Provisional,103,Secretary Of State,98,5
Dodge,Absentee by Mail,448,Secretary Of State,434,14
Dodge,Advance in Person,3411,Secretary Of State,3300,111
Dodge,Election Day,3192,Secretary Of State,3089,103
Dodge,Provisional,10,Secretary Of State,10,0
Dooly,Absentee by Mail,196,Secretary Of State,191,5
Dooly,Advance in Person,1889,Secretary Of State,1817,72
Dooly,Election Day,1708,Secretary Of State,1659,49
Dooly,Provisional,2,Secretary Of State,1,1
Dougherty,Absentee by Mail,1944,Secretary Of State,1926,18
Dougherty,Advance in Person,11332,Secretary Of State,11130,202
Dougherty,Election Day,18021,Secretary Of State,17710,311
Dougherty,Provisional,128,Secretary Of State,125,3
Douglas,Absentee by Mail,3233,Secretary Of State,3208,25
Douglas,Advance in Person,30219,Secretary Of State,29941,278
Douglas,Election Day,21745,Secretary Of State,21491,254
Douglas,Provisional,58,Secretary Of State,58,0
Early,Absentee by Mail,473,Secretary Of State,463,10
Early,Advance in Person,1569,Secretary Of State,1549,20
Early,Election Day,2089,Secretary Of State,2047,42
Early,Provisional,4,Secretary Of State,4,0
Echols,Absentee by Mail,35,Secretary Of State,35,0
Echols,Advance in Person,767,Secretary Of State,745,22
Echols,Election Day,341,Secretary Of State,327,14
Echols,Provisional,0,Secretary Of State,0,0
Effingham,Absentee by Mail,750,Secretary Of State,743,7
Effingham,Advance in Person,10717,Secretary Of State,10623,94
Effingham,Election Day,11898,Secretary Of State,11804,94
Effingham,Provisional,6,Secretary Of State,6,0
Elbert,Absentee by Mail,563,Secretary Of State,559,4
Elbert,Advance in Person,3722,Secretary Of State,3643,79
Elbert,Election Day,3034,Secretary Of State,2971,63
Elbert,Provisional,69,Secretary Of State,66,3
Emanuel,Absentee by Mail,390,Secretary Of State,385,5
Emanuel,Advance in Person,3424,Secretary Of State,3385,39
Emanuel,Election Day,3896,Secretary Of State,3808,88
Emanuel,Provisional,6,Secretary Of State,6,0
Evans,Absentee by Mail,199,Secretary Of State,198,1
Evans,Advance in Person,2162,Secretary Of State,2123,39
Evans,Election Day,1086,Secretary Of State,1063,23
Evans,Provisional,0,Secretary Of State,0,0
Fannin,Absentee by Mail,658,Secretary Of State,651,7
Fannin,Advance in Person,5341,Secretary Of State,5265,76
Fannin,Election Day,5204,Secretary Of State,5084,120
Fannin,Provisional,16,Secretary Of State,16,0
Fayette,Absentee by Mail,2647,Secretary Of State,2617,30
Fayette,Advance in Person,31073,Secretary Of State,30760,313
Fayette,Election Day,24242,Secretary Of State,23900,342
Fayette,Provisional,36,Secretary Of State,34,2
Floyd,Absentee by Mail,1260,Secretary Of State,1245,15
Floyd,Advance in Person,13688,Secretary Of State,13526,162
Floyd,Election Day,15277,Secretary Of State,14979,298
Floyd,Provisional,113,Secretary Of State,110,3
Forsyth,Absentee by Mail,4428,Secretary Of State,4378,50
Forsyth,Advance in Person,52559,Secretary Of State,52086,473
Forsyth,Election Day,36252,Secretary Of State,35850,402
Forsyth,Provisional,59,Secretary Of State,59,0
Franklin,Absentee by Mail,388,Secretary Of State,382,6
Franklin,Advance in Person,3502,Secretary Of State,3445,57
Franklin,Election Day,4259,Secretary Of State,4182,77
Franklin,Provisional,0,Secretary Of State,0,0
Fulton,Absentee by Mail,17842,Secretary Of State,17510,332
Fulton,Advance in Person,224522,Secretary Of State,221497,3025
Fulton,Election Day,179442,Secretary Of State,176373,3069
Fulton,Provisional,1982,Secretary Of State,1904,78
Gilmer,Absentee by Mail,559,Secretary Of State,553,6
Gilmer,Advance in Person,6295,Secretary Of State,6207,88
Gilmer,Election Day,5617,Secretary Of State,5501,116
Gilmer,Provisional,39,Secretary Of State,37,2
Glascock,Absentee by Mail,81,Secretary Of State,80,1
Glascock,Advance in Person,652,Secretary Of State,633,19
Glascock,Election Day,567,Secretary Of State,541,26
Glascock,Provisional,1,Secretary Of State,1,0
Glynn,Absentee by Mail,1812,Secretary Of State,1797,15
Glynn,Advance in Person,17510,Secretary Of State,17284,226
Glynn,Election Day,13179,Secretary Of State,12955,224
Glynn,Provisional,147,Secretary Of State,141,6
Gordon,Absentee by Mail,547,Secretary Of State,537,10
Gordon,Advance in Person,8119,Secretary Of State,7974,145
Gordon,Election Day,9106,Secretary Of State,8943,163
Gordon,Provisional,32,Secretary Of State,31,1
Grady,Absentee by Mail,400,Secretary Of State,395,5
Grady,Advance in Person,3857,Secretary Of State,3795,62
Grady,Election Day,4099,Secretary Of State,4020,79
Grady,Provisional,14,Secretary Of State,14,0
Greene,Absentee by Mail,623,Secretary Of State,613,10
Greene,Advance in Person,5593,Secretary Of State,5552,41
Greene,Election Day,2773,Secretary Of State,2721,52
Greene,Provisional,6,Secretary Of State,6,0
Gwinnett,Absentee by Mail,20397,Secretary Of State,20190,207
Gwinnett,Advance in Person,137166,Secretary Of State,135953,1213
Gwinnett,Election Day,155146,Secretary Of State,153356,1790
Gwinnett,Provisional,2209,Secretary Of State,2161,48
Habersham,Absentee by Mail,853,Secretary Of State,840,13
Habersham,Advance in Person,10023,Secretary Of State,9861,162
Habersham,Election Day,4619,Secretary Of State,4522,97
Habersham,Provisional,5,Secretary Of State,5,0
Hall,Absentee by Mail,3493,Secretary Of State,3460,33
Hall,Advance in Person,24348,Secretary Of State,24019,329
Hall,Election Day,39441,Secretary Of State,38866,575
Hall,Provisional,124,Secretary Of State,118,6
Hancock,Absentee by Mail,490,Secretary Of State,477,13
Hancock,Advance in Person,1531,Secretary Of State,1494,37
Hancock,Election Day,1518,Secretary Of State,1474,44
Hancock,Provisional,9,Secretary Of State,8,1
Haralson,Absentee by Mail,393,Secretary Of State,390,3
Haralson,Advance in Person,4202,Secretary Of State,4142,60
Haralson,Election Day,5990,Secretary Of State,5911,79
Haralson,Provisional,0,Secretary Of State,0,0
Harris,Absentee by Mail,729,Secretary Of State,723,6
Harris,Advance in Person,7251,Secretary Of State,7163,88
Harris,Election Day,7992,Secretary Of State,7870,122
Harris,Provisional,14,Secretary Of State,14,0
Hart,Absentee by Mail,440,Secretary Of State,433,7
Hart,Advance in Person,5220,Secretary Of State,5101,119
Hart,Election Day,3958,Secretary Of State,3862,96
Hart,Provisional,4,Secretary Of State,4,0
Heard,Absentee by Mail,278,Secretary Of State,271,7
Heard,Advance in Person,1427,Secretary Of State,1394,33
Heard,Election Day,2346,Secretary Of State,2310,36
Heard,Provisional,4,Secretary Of State,4,0
Henry,Absentee by Mail,4997,Secretary Of State,4929,68
Henry,Advance in Person,58658,Secretary Of State,58059,599
Henry,Election Day,34710,Secretary Of State,34287,423
Henry,Provisional,193,Secretary Of State,189,4
Houston,Absentee by Mail,3190,Secretary Of State,3157,33
Houston,Advance in Person,34816,Secretary Of State,34458,358
Houston,Election Day,21152,Secretary Of State,20861,291
Houston,Provisional,74,Secretary Of State,70,4
Irwin,Absentee by Mail,133,Secretary Of State,133,0
Irwin,Advance in Person,2048,Secretary Of State,1997,51
Irwin,Election Day,1375,Secretary Of State,1353,22
Irwin,Provisional,8,Secretary Of State,8,0
Jackson,Absentee by Mail,1019,Secretary Of State,1010,9
Jackson,Advance in Person,14919,Secretary Of State,14763,156
Jackson,Election Day,10951,Secretary Of State,10821,130
Jackson,Provisional,10,Secretary Of State,10,0
Jasper,Absentee by Mail,421,Secretary Of State,415,6
Jasper,Advance in Person,2981,Secretary Of State,2941,40
Jasper,Election Day,2505,Secretary Of State,2460,45
Jasper,Provisional,38,Secretary Of State,37,1
Jeff Davis,Absentee by Mail,229,Secretary Of State,223,6
Jeff Davis,Advance in Person,2680,Secretary Of State,2606,74
Jeff Davis,Election Day,1906,Secretary Of State,1828,78
Jeff Davis,Provisional,0,Secretary Of State,0,0
Jefferson,Absentee by Mail,607,Secretary Of State,596,11
Jefferson,Advance in Person,2803,Secretary Of State,2733,70
Jefferson,Election Day,3346,Secretary Of State,3272,74
Jefferson,Provisional,11,Secretary Of State,11,0
Jenkins,Absentee by Mail,188,Secretary Of State,186,2
Jenkins,Advance in Person,1557,Secretary Of State,1529,28
Jenkins,Election Day,1111,Secretary Of State,1091,20
Jenkins,Provisional,16,Secretary Of State,16,0
Johnson,Absentee by Mail,236,Secretary Of State,228,8
Johnson,Advance in Person,1970,Secretary Of State,1911,59
Johnson,Election Day,1277,Secretary Of State,1232,45
Johnson,Provisional,0,Secretary Of State,0,0
Jones,Absentee by Mail,784,Secretary Of State,773,11
Jones,Advance in Person,6968,Secretary Of State,6867,101
Jones,Election Day,4680,Secretary Of State,4616,64
Jones,Provisional,9,Secretary Of State,9,0
Lamar,Absentee by Mail,404,Secretary Of State,399,5
Lamar,Advance in Person,3820,Secretary Of State,3761,59
Lamar,Election Day,3122,Secretary Of State,3082,40
Lamar,Provisional,11,Secretary Of State,11,0
Lanier,Absentee by Mail,108,Secretary Of State,106,2
Lanier,Advance in Person,1661,Secretary Of State,1612,49
Lanier,Election Day,910,Secretary Of State,871,39
Lanier,Provisional,2,Secretary Of State,2,0
Laurens,Absentee by Mail,1286,Secretary Of State,1259,27
Laurens,Advance in Person,8485,Secretary Of State,8313,172
Laurens,Election Day,9168,Secretary Of State,8985,183
Laurens,Provisional,13,Secretary Of State,12,1
Lee,Absentee by Mail,480,Secretary Of State,477,3
Lee,Advance in Person,5681,Secretary Of State,5618,63
Lee,Election Day,7388,Secretary Of State,7300,88
Lee,Provisional,6,Secretary Of State,6,0
Liberty,Absentee by Mail,950,Secretary Of State,942,8
Liberty,Advance in Person,8143,Secretary Of State,8057,86
Liberty,Election Day,6265,Secretary Of State,6196,69
Liberty,Provisional,10,Secretary Of State,10,0
Lincoln,Absentee by Mail,350,Secretary Of State,346,4
Lincoln,Advance in Person,1937,Secretary Of State,1906,31
Lincoln,Election Day,1680,Secretary Of State,1646,34
Lincoln,Provisional,2,Secretary Of State,2,0
Long,Absentee by Mail,169,Secretary Of State,168,1
Long,Advance in Person,1971,Secretary Of State,1937,34
Long,Election Day,1848,Secretary Of State,1813,35
Long,Provisional,10,Secretary Of State,10,0
Lowndes,Absentee by Mail,1890,Secretary Of State,1860,30
Lowndes,Advance in Person,21238,Secretary Of State,20990,248
Lowndes,Election Day,12084,Secretary Of State,11866,218
Lowndes,Provisional,541,Secretary Of State,523,18
Lumpkin,Absentee by Mail,467,Secretary Of State,462,5
Lumpkin,Advance in Person,7377,Secretary Of State,7301,76
Lumpkin,Election Day,3707,Secretary Of State,3646,61
Lumpkin,Provisional,7,Secretary Of State,7,0
Macon,Absentee by Mail,331,Secretary Of State,325,6
Macon,Advance in Person,2251,Secretary Of State,2157,94
Macon,Election Day,1635,Secretary Of State,1580,55
Macon,Provisional,0,Secretary Of State,0,0
Madison,Absentee by Mail,527,Secretary Of State,523,4
Madison,Advance in Person,5242,Secretary Of State,5154,88
Madison,Election Day,5928,Secretary Of State,5847,81
Madison,Provisional,2,Secretary Of State,2,0
Marion,Absentee by Mail,241,Secretary Of State,237,4
Marion,Advance in Person,1222,Secretary Of State,1180,42
Marion,Election Day,1467,Secretary Of State,1427,40
Marion,Provisional,1,Secretary Of State,1,0
McDuffie,Absentee by Mail,868,Secretary Of State,858,10
McDuffie,Advance in Person,5045,Secretary Of State,4970,75
McDuffie,Election Day,2879,Secretary Of State,2834,45
McDuffie,Provisional,0,Secretary Of State,0,0
McIntosh,Absentee by Mail,440,Secretary Of State,436,4
McIntosh,Advance in Person,2945,Secretary Of State,2906,39
McIntosh,Election Day,2023,Secretary Of State,1974,49
McIntosh,Provisional,0,Secretary Of State,0,0
Meriwether,Absentee by Mail,483,Secretary Of State,478,5
Meriwether,Advance in Person,2831,Secretary Of State,2770,61
Meriwether,Election Day,5325,Secretary Of State,5220,105
Meriwether,Provisional,11,Secretary Of State,11,0
Miller,Absentee by Mail,132,Secretary Of State,127,5
Miller,Advance in Person,1029,Secretary Of State,980,49
Miller,Election Day,1152,Secretary Of State,1100,52
Miller,Provisional,2,Secretary Of State,2,0
Mitchell,Absentee by Mail,564,Secretary Of State,555,9
Mitchell,Advance in Person,3343,Secretary Of State,3281,62
Mitchell,Election Day,3539,Secretary Of State,3471,68
Mitchell,Provisional,9,Secretary Of State,9,0
Monroe,Absentee by Mail,696,Secretary Of State,696,0
Monroe,Advance in Person,6311,Secretary Of State,6205,106
Monroe,Election Day,5925,Secretary Of State,5846,79
Monroe,Provisional,10,Secretary Of State,10,0
Montgomery,Absentee by Mail,211,Secretary Of State,206,5
Montgomery,Advance in Person,1416,Secretary Of State,1385,31
Montgomery,Election Day,1901,Secretary Of State,1850,51
Montgomery,Provisional,0,Secretary Of State,0,0
Morgan,Absentee by Mail,410,Secretary Of State,400,10
Morgan,Advance in Person,5406,Secretary Of State,5323,83
Morgan,Election Day,3738,Secretary Of State,3677,61
Morgan,Provisional,4,Secretary Of State,4,0
Murray,Absentee by Mail,265,Secretary Of State,256,9
Murray,Advance in Person,5111,Secretary Of State,4997,114
Murray,Election Day,5715,Secretary Of State,5582,133
Murray,Provisional,0,Secretary Of State,0,0
Muscogee,Absentee by Mail,4422,Secretary Of State,4353,69
Muscogee,Advance in Person,27700,Secretary Of State,27224,476
Muscogee,Election Day,31019,Secretary Of State,30513,506
Muscogee,Provisional,131,Secretary Of State,126,5
Newton,Absentee by Mail,2735,Secretary Of State,2698,37
Newton,Advance in Person,19236,Secretary Of State,18964,272
Newton,Election Day,21158,Secretary Of State,20878,280
Newton,Provisional,12,Secretary Of State,12,0
Oconee,Absentee by Mail,931,Secretary Of State,916,15
Oconee,Advance in Person,11688,Secretary Of State,11572,116
Oconee,Election Day,8114,Secretary Of State,8001,113
Oconee,Provisional,11,Secretary Of State,11,0
Oglethorpe,Absentee by Mail,409,Secretary Of State,406,3
Oglethorpe,Advance in Person,3417,Secretary Of State,3374,43
Oglethorpe,Election Day,2658,Secretary Of State,2607,51
Oglethorpe,Provisional,1,Secretary Of State,1,0
Paulding,Absentee by Mail,3307,Secretary Of State,3266,41
Paulding,Advance in Person,32842,Secretary Of State,32446,396
Paulding,Election Day,25073,Secretary Of State,24784,289
Paulding,Provisional,83,Secretary Of State,81,2
Peach,Absentee by Mail,445,Secretary Of State,440,5
Peach,Advance in Person,6720,Secretary Of State,6605,115
Peach,Election Day,3190,Secretary Of State,3138,52
Peach,Provisional,90,Secretary Of State,85,5
Pickens,Absentee by Mail,222,Secretary Of State,219,3
Pickens,Advance in Person,7121,Secretary Of State,7028,93
Pickens,Election Day,6019,Secretary Of State,5921,98
Pickens,Provisional,0,Secretary Of State,0,0
Pierce,Absentee by Mail,327,Secretary Of State,325,2
Pierce,Advance in Person,4598,Secretary Of State,4538,60
Pierce,Election Day,1958,Secretary Of State,1923,35
Pierce,Provisional,1,Secretary Of State,1,0
Pike,Absentee by Mail,304,Secretary Of State,301,3
Pike,Advance in Person,4478,Secretary Of State,4431,47
Pike,Election Day,3752,Secretary Of State,3698,54
Pike,Provisional,9,Secretary Of State,9,0
Polk,Absentee by Mail,447,Secretary Of State,443,4
Polk,Advance in Person,7744,Secretary Of State,7611,133
Polk,Election Day,4668,Secretary Of State,4571,97
Polk,Provisional,2,Secretary Of State,2,0
Pulaski,Absentee by Mail,232,Secretary Of State,223,9
Pulaski,Advance in Person,2522,Secretary Of State,2431,91
Pulaski,Election Day,868,Secretary Of State,827,41
Pulaski,Provisional,0,Secretary Of State,0,0
Putnam,Absentee by Mail,598,Secretary Of State,595,3
Putnam,Advance in Person,4858,Secretary Of State,4798,60
Putnam,Election Day,3865,Secretary Of State,3804,61
Putnam,Provisional,14,Secretary Of State,14,0
Quitman,Absentee by Mail,60,Secretary Of State,52,8
Quitman,Advance in Person,451,Secretary Of State,429,22
Quitman,Election Day,429,Secretary Of State,412,17
Quitman,Provisional,0,Secretary Of State,0,0
Rabun,Absentee by Mail,843,Secretary Of State,830,13
Rabun,Advance in Person,4889,Secretary Of State,4817,72
Rabun,Election Day,1846,Secretary Of State,1804,42
Rabun,Provisional,0,Secretary Of State,0,0
Randolph,Absentee by Mail,313,Secretary Of State,305,8
Randolph,Advance in Person,1232,Secretary Of State,1192,40
Randolph,Election Day,1243,Secretary Of State,1202,41
Randolph,Provisional,1,Secretary Of State,1,0
Richmond,Absentee by Mail,5314,Secretary Of State,5258,56
Richmond,Advance in Person,28737,Secretary Of State,28486,251
Richmond,Election Day,35992,Secretary Of State,35646,346
Richmond,Provisional,112,Secretary Of State,108,4
Rockdale,Absentee by Mail,1853,Secretary Of State,1832,21
Rockdale,Advance in Person,22789,Secretary Of State,22533,256
Rockdale,Election Day,11958,Secretary Of State,11797,161
Rockdale,Provisional,55,Secretary Of State,52,3
Schley,Absentee by Mail,96,Secretary Of State,96,0
Schley,Advance in Person,1321,Secretary Of State,1283,38
Schley,Election Day,514,Secretary Of State,497,17
Schley,Provisional,2,Secretary Of State,2,0
Screven,Absentee by Mail,271,Secretary Of State,264,7
Screven,Advance in Person,2674,Secretary Of State,2629,45
Screven,Election Day,2462,Secretary Of State,2421,41
Screven,Provisional,7,Secretary Of State,7,0
Seminole,Absentee by Mail,264,Secretary Of State,258,6
Seminole,Advance in Person,1078,Secretary Of State,1066,12
Seminole,Election Day,1872,Secretary Of State,1828,44
Seminole,Provisional,13,Secretary Of State,12,1
Spalding,Absentee by Mail,1283,Secretary Of State,1259,24
Spalding,Advance in Person,13046,Secretary Of State,12794,252
Spalding,Election Day,10056,Secretary Of State,9874,182
Spalding,Provisional,32,Secretary Of State,29,3
Stephens,Absentee by Mail,536,Secretary Of State,529,7
Stephens,Advance in Person,6139,Secretary Of State,6039,100
Stephens,Election Day,2394,Secretary Of State,2335,59
Stephens,Provisional,18,Secretary Of State,17,1
Stewart,Absentee by Mail,233,Secretary Of State,226,7
Stewart,Advance in Person,694,Secretary Of State,659,35
Stewart,Election Day,857,Secretary Of State,792,65
Stewart,Provisional,35,Secretary Of State,35,0
Sumter,Absentee by Mail,877,Secretary Of State,857,20
Sumter,Advance in Person,5531,Secretary Of State,5430,101
Sumter,Election Day,4148,Secretary Of State,4054,94
Sumter,Provisional,0,Secretary Of State,0,0
Talbot,Absentee by Mail,285,Secretary Of State,266,19
Talbot,Advance in Person,772,Secretary Of State,744,28
Talbot,Election Day,1895,Secretary Of State,1824,71
Talbot,Provisional,2,Secretary Of State,2,0
Taliaferro,Absentee by Mail,162,Secretary Of State,154,8
Taliaferro,Advance in Person,441,Secretary Of State,416,25
Taliaferro,Election Day,314,Secretary Of State,295,19
Taliaferro,Provisional,4,Secretary Of State,4,0
Tattnall,Absentee by Mail,392,Secretary Of State,390,2
Tattnall,Advance in Person,3539,Secretary Of State,3459,80
Tattnall,Election Day,2708,Secretary Of State,2665,43
Tattnall,Provisional,8,Secretary Of State,8,0
Taylor,Absentee by Mail,243,Secretary Of State,241,2
Taylor,Advance in Person,1843,Secretary Of State,1821,22
Taylor,Election Day,1179,Secretary Of State,1155,24
Taylor,Provisional,29,Secretary Of State,29,0
Telfair,Absentee by Mail,331,Secretary Of State,325,6
Telfair,Advance in Person,1676,Secretary Of State,1625,51
Telfair,Election Day,1624,Secretary Of State,1582,42
Telfair,Provisional,1,Secretary Of State,1,0
Terrell,Absentee by Mail,327,Secretary Of State,324,3
Terrell,Advance in Person,1612,Secretary Of State,1578,34
Terrell,Election Day,1991,Secretary Of State,1943,48
Terrell,Provisional,9,Secretary Of State,9,0
Thomas,Absentee by Mail,991,Secretary Of State,982,9
Thomas,Advance in Person,8376,Secretary Of State,8197,179
Thomas,Election Day,7874,Secretary Of State,7703,171
Thomas,Provisional,3,Secretary Of State,3,0
Tift,Absentee by Mail,561,Secretary Of State,546,15
Tift,Advance in Person,7646,Secretary Of State,7483,163
Tift,Election Day,5462,Secretary Of State,5335,127
Tift,Provisional,4,Secretary Of State,3,1
Toombs,Absentee by Mail,681,Secretary Of State,670,11
Toombs,Advance in Person,4860,Secretary Of State,4782,78
Toombs,Election Day,3310,Secretary Of State,3241,69
Toombs,Provisional,9,Secretary Of State,9,0
Towns,Absentee by Mail,284,Secretary Of State,282,2
Towns,Advance in Person,4009,Secretary Of State,3932,77
Towns,Election Day,1839,Secretary Of State,1802,37
Towns,Provisional,0,Secretary Of State,0,0
Treutlen,Absentee by Mail,146,Secretary Of State,139,7
Treutlen,Advance in Person,1659,Secretary Of State,1599,60
Treutlen,Election Day,805,Secretary Of State,775,30
Treutlen,Provisional,4,Secretary Of State,4,0
Troup,Absentee by Mail,1264,Secretary Of State,1238,26
Troup,Advance in Person,11226,Secretary Of State,11051,175
Troup,Election Day,11173,Secretary Of State,10951,222
Troup,Provisional,250,Secretary Of State,242,8
Turner,Absentee by Mail,148,Secretary Of State,147,1
Turner,Advance in Person,1922,Secretary Of State,1865,57
Turner,Election Day,1199,Secretary Of State,1168,31
Turner,Provisional,5,Secretary Of State,5,0
Twiggs,Absentee by Mail,275,Secretary Of State,273,2
Twiggs,Advance in Person,1531,Secretary Of State,1496,35
Twiggs,Election Day,1981,Secretary Of State,1919,62
Twiggs,Provisional,5,Secretary Of State,5,0
Union,Absentee by Mail,482,Secretary Of State,477,5
Union,Advance in Person,6626,Secretary Of State,6537,89
Union,Election Day,4755,Secretary Of State,4661,94
Union,Provisional,2,Secretary Of State,2,0
Upson,Absentee by Mail,602,Secretary Of State,594,8
Upson,Advance in Person,6729,Secretary Of State,6581,148
Upson,Election Day,3227,Secretary Of State,3163,64
Upson,Provisional,10,Secretary Of State,10,0
Walker,Absentee by Mail,813,Secretary Of State,804,9
Walker,Advance in Person,11133,Secretary Of State,10932,201
Walker,Election Day,9505,Secretary Of State,9329,176
Walker,Provisional,39,Secretary Of State,37,2
Walton,Absentee by Mail,1769,Secretary Of State,1751,18
Walton,Advance in Person,14370,Secretary Of State,14175,195
Walton,Election Day,22496,Secretary Of State,22214,282
Walton,Provisional,51,Secretary Of State,50,1
Ware,Absentee by Mail,627,Secretary Of State,619,8
Ware,Advance in Person,5460,Secretary Of State,5401,59
Ware,Election Day,4917,Secretary Of State,4818,99
Ware,Provisional,12,Secretary Of State,12,0
Warren,Absentee by Mail,187,Secretary Of State,184,3
Warren,Advance in Person,1267,Secretary Of State,1230,37
Warren,Election Day,806,Secretary Of State,781,25
Warren,Provisional,1,Secretary Of State,1,0
Washington,Absentee by Mail,727,Secretary Of State,714,13
Washington,Advance in Person,3907,Secretary Of State,3806,101
Washington,Election Day,3525,Secretary Of State,3424,101
Washington,Provisional,10,Secretary Of State,10,0
Wayne,Absentee by Mail,501,Secretary Of State,498,3
Wayne,Advance in Person,5868,Secretary Of State,5755,113
Wayne,Election Day,3753,Secretary Of State,3686,67
Wayne,Provisional,10,Secretary Of State,10,0
Webster,Absentee by Mail,152,Secretary Of State,151,1
Webster,Advance in Person,544,Secretary Of State,523,21
Webster,Election Day,404,Secretary Of State,389,15
Webster,Provisional,0,Secretary Of State,0,0
Wheeler,Absentee by Mail,115,Secretary Of State,115,0
Wheeler,Advance in Person,974,Secretary Of State,958,16
Wheeler,Election Day,838,Secretary Of State,817,21
Wheeler,Provisional,4,Secretary Of State,3,1
White,Absentee by Mail,537,Secretary Of State,527,10
White,Advance in Person,5408,Secretary Of State,5325,83
White,Election Day,5489,Secretary Of State,5433,56
White,Provisional,6,Secretary Of State,6,0
Whitfield,Absentee by Mail,1017,Secretary Of State,1004,13
Whitfield,Advance in Person,9610,Secretary Of State,9455,155
Whitfield,Election Day,16675,Secretary Of State,16342,333
Whitfield,Provisional,25,Secretary Of State,24,1
Wilcox,Absentee by Mail,205,Secretary Of State,201,4
Wilcox,Advance in Person,1202,Secretary Of State,1181,21
Wilcox,Election Day,1408,Secretary Of State,1361,47
Wilcox,Provisional,0,Secretary Of State,0,0
Wilkes,Absentee by Mail,301,Secretary Of State,291,10
Wilkes,Advance in Person,2075,Secretary Of State,2023,52
Wilkes,Election Day,1995,Secretary Of State,1935,60
Wilkes,Provisional,6,Secretary Of State,6,0
Wilkinson,Absentee by Mail,270,Secretary Of State,266,4
Wilkinson,Advance in Person,1567,Secretary Of State,1529,38
Wilkinson,Election Day,2427,Secretary Of State,2363,64
Wilkinson,Provisional,1,Secretary Of State,1,0
Worth,Absentee by Mail,305,Secretary Of State,301,4
Worth,Advance in Person,3108,Secretary Of State,3057,51
Worth,Election Day,4418,Secretary Of State,4333,85
Worth,Provisional,15,Secretary Of State,15,0
Appling,Absentee by Mail,530,Attorney General,519,11
Appling,Advance in Person,3298,Attorney General,3180,118
Appling,Election Day,2978,Attorney General,2860,118
Appling,Provisional,3,Attorney General,3,0
Atkinson,Absentee by Mail,88,Attorney General,88,0
Atkinson,Advance in Person,1285,Attorney General,1229,56
Atkinson,Election Day,1147,Attorney General,1093,54
Atkinson,Provisional,2,Attorney General,2,0
Bacon,Absentee by Mail,174,Attorney General,171,3
Bacon,Advance in Person,2828,Attorney General,2752,76
Bacon,Election Day,827,Attorney General,776,51
Bacon,Provisional,1,Attorney General,1,0
Baker,Absentee by Mail,141,Attorney General,133,8
Baker,Advance in Person,485,Attorney General,466,19
Baker,Election Day,665,Attorney General,634,31
Baker,Provisional,2,Attorney General,2,0
Baldwin,Absentee by Mail,1158,Attorney General,1143,15
Baldwin,Advance in Person,8295,Attorney General,8077,218
Baldwin,Election Day,6180,Attorney General,5979,201
Baldwin,Provisional,3,Attorney General,3,0
Banks,Absentee by Mail,223,Attorney General,220,3
Banks,Advance in Person,2771,Attorney General,2712,59
Banks,Election Day,3858,Attorney General,3772,86
Banks,Provisional,1,Attorney General,1,0
Barrow,Absentee by Mail,1263,Attorney General,1243,20
Barrow,Advance in Person,12223,Attorney General,12021,202
Barrow,Election Day,13912,Attorney General,13662,250
Barrow,Provisional,7,Attorney General,7,0
Bartow,Absentee by Mail,1568,Attorney General,1551,17
Bartow,Advance in Person,16175,Attorney General,15856,319
Bartow,Election Day,19584,Attorney General,19179,405
Bartow,Provisional,32,Attorney General,32,0
Ben Hill,Absentee by Mail,320,Attorney General,312,8
Ben Hill,Advance in Person,3605,Attorney General,3511,94
Ben Hill,Election Day,1608,Attorney General,1565,43
Ben Hill,Provisional,14,Attorney General,12,2
Berrien,Absentee by Mail,322,Attorney General,318,4
Berrien,Advance in Person,3153,Attorney General,3079,74
Berrien,Election Day,2772,Attorney General,2706,66
Berrien,Provisional,5,Attorney General,4,1
Bibb,Absentee by Mail,4461,Attorney General,4414,47
Bibb,Advance in Person,26183,Attorney General,25605,578
Bibb,Election Day,29816,Attorney General,29147,669
Bibb,Provisional,232,Attorney General,228,4
Bleckley,Absentee by Mail,257,Attorney General,253,4
Bleckley,Advance in Person,2805,Attorney General,2726,79
Bleckley,Election Day,1793,Attorney General,1728,65
Bleckley,Provisional,5,Attorney General,5,0
Brantley,Absentee by Mail,188,Attorney General,185,3
Brantley,Advance in Person,2868,Attorney General,2814,54
Brantley,Election Day,2633,Attorney General,2547,86
Brantley,Provisional,5,Attorney General,5,0
Brooks,Absentee by Mail,465,Attorney General,457,8
Brooks,Advance in Person,2417,Attorney General,2349,68
Brooks,Election Day,2814,Attorney General,2731,83
Brooks,Provisional,27,Attorney General,27,0
Bryan,Absentee by Mail,582,Attorney General,572,10
Bryan,Advance in Person,8342,Attorney General,8212,130
Bryan,Election Day,6046,Attorney General,5925,121
Bryan,Provisional,15,Attorney General,15,0
Bulloch,Absentee by Mail,1076,Attorney General,1053,23
Bulloch,Advance in Person,11170,Attorney General,10916,254
Bulloch,Election Day,11297,Attorney General,11018,279
Bulloch,Provisional,140,Attorney General,134,6
Burke,Absentee by Mail,968,Attorney General,960,8
Burke,Advance in Person,3199,Attorney General,3119,80
Burke,Election Day,4552,Attorney General,4427,125
Burke,Provisional,2,Attorney General,2,0
Butts,Absentee by Mail,380,Attorney General,374,6
Butts,Advance in Person,6277,Attorney General,6130,147
Butts,Election Day,2206,Attorney General,2157,49
Butts,Provisional,0,Attorney General,0,0
Calhoun,Absentee by Mail,185,Attorney General,183,2
Calhoun,Advance in Person,607,Attorney General,592,15
Calhoun,Election Day,1107,Attorney General,1083,24
Calhoun,Provisional,0,Attorney General,0,0
Camden,Absentee by Mail,1193,Attorney General,1180,13
Camden,Advance in Person,8085,Attorney General,7977,108
Camden,Election Day,7775,Attorney General,7592,183
Camden,Provisional,8,Attorney General,8,0
Candler,Absentee by Mail,120,Attorney General,117,3
Candler,Advance in Person,2335,Attorney General,2276,59
Candler,Election Day,1083,Attorney General,1050,33
Candler,Provisional,1,Attorney General,1,0
Carroll,Absentee by Mail,1518,Attorney General,1501,17
Carroll,Advance in Person,20100,Attorney General,19784,316
Carroll,Election Day,20121,Attorney General,19700,421
Carroll,Provisional,104,Attorney General,102,2
Catoosa,Absentee by Mail,540,Attorney General,529,11
Catoosa,Advance in Person,13673,Attorney General,13434,239
Catoosa,Election Day,9512,Attorney General,9333,179
Catoosa,Provisional,33,Attorney General,33,0
Charlton,Absentee by Mail,163,Attorney General,161,2
Charlton,Advance in Person,1549,Attorney General,1523,26
Charlton,Election Day,1657,Attorney General,1602,55
Charlton,Provisional,8,Attorney General,8,0
Chatham,Absentee by Mail,6177,Attorney General,6083,94
Chatham,Advance in Person,32338,Attorney General,31738,600
Chatham,Election Day,64823,Attorney General,63331,1492
Chatham,Provisional,205,Attorney General,203,2
Chattahoochee,Absentee by Mail,35,Attorney General,35,0
Chattahoochee,Advance in Person,493,Attorney General,470,23
Chattahoochee,Election Day,574,Attorney General,560,14
Chattahoochee,Provisional,3,Attorney General,3,0
Chattooga,Absentee by Mail,225,Attorney General,219,6
Chattooga,Advance in Person,3452,Attorney General,3371,81
Chattooga,Election Day,3750,Attorney General,3630,120
Chattooga,Provisional,7,Attorney General,7,0
Cherokee,Absentee by Mail,5312,Attorney General,5254,58
Cherokee,Advance in Person,48565,Attorney General,47945,620
Cherokee,Election Day,52422,Attorney General,51403,1019
Cherokee,Provisional,112,Attorney General,107,5
Clarke,Absentee by Mail,3022,Attorney General,2975,47
Clarke,Advance in Person,19957,Attorney General,19610,347
Clarke,Election Day,20282,Attorney General,19717,565
Clarke,Provisional,41,Attorney General,40,1
Clay,Absentee by Mail,143,Attorney General,140,3
Clay,Advance in Person,579,Attorney General,559,20
Clay,Election Day,464,Attorney General,441,23
Clay,Provisional,0,Attorney General,0,0
Clayton,Absentee by Mail,5847,Attorney General,5739,108
Clayton,Advance in Person,47671,Attorney General,46856,815
Clayton,Election Day,38322,Attorney General,37492,830
Clayton,Provisional,372,Attorney General,358,14
Clinch,Absentee by Mail,109,Attorney General,106,3
Clinch,Advance in Person,1236,Attorney General,1182,54
Clinch,Election Day,909,Attorney General,871,38
Clinch,Provisional,4,Attorney General,4,0
Cobb,Absentee by Mail,25901,Attorney General,25532,369
Cobb,Advance in Person,111554,Attorney General,110384,1170
Cobb,Election Day,172926,Attorney General,170277,2649
Cobb,Provisional,1433,Attorney General,1388,45
Coffee,Absentee by Mail,395,Attorney General,391,4
Coffee,Advance in Person,7664,Attorney General,7395,269
Coffee,Election Day,4536,Attorney General,4374,162
Coffee,Provisional,20,Attorney General,20,0
Colquitt,Absentee by Mail,514,Attorney General,507,7
Colquitt,Advance in Person,6071,Attorney General,5907,164
Colquitt,Election Day,6368,Attorney General,6154,214
Colquitt,Provisional,10,Attorney General,10,0
Columbia,Absentee by Mail,2936,Attorney General,2896,40
Columbia,Advance in Person,29686,Attorney General,29326,360
Columbia,Election Day,28969,Attorney General,28521,448
Columbia,Provisional,43,Attorney General,43,0
Cook,Absentee by Mail,244,Attorney General,242,2
Cook,Advance in Person,3069,Attorney General,3009,60
Cook,Election Day,2490,Attorney General,2437,53
Cook,Provisional,0,Attorney General,0,0
Coweta,Absentee by Mail,2812,Attorney General,2782,30
Coweta,Advance in Person,25641,Attorney General,25300,341
Coweta,Election Day,29603,Attorney General,29066,537
Coweta,Provisional,15,Attorney General,15,0
Crawford,Absentee by Mail,234,Attorney General,230,4
Crawford,Advance in Person,2567,Attorney General,2487,80
Crawford,Election Day,2130,Attorney General,2085,45
Crawford,Provisional,3,Attorney General,3,0
Crisp,Absentee by Mail,363,Attorney General,353,10
Crisp,Advance in Person,4191,Attorney General,4075,116
Crisp,Election Day,2470,Attorney General,2353,117
Crisp,Provisional,26,Attorney General,23,3
Dade,Absentee by Mail,129,Attorney General,123,6
Dade,Advance in Person,2561,Attorney General,2477,84
Dade,Election Day,2760,Attorney General,2663,97
Dade,Provisional,12,Attorney General,12,0
Dawson,Absentee by Mail,439,Attorney General,437,2
Dawson,Advance in Person,7020,Attorney General,6910,110
Dawson,Election Day,4111,Attorney General,4032,79
Dawson,Provisional,11,Attorney General,11,0
DeKalb,Absentee by Mail,19672,Attorney General,19259,413
DeKalb,Advance in Person,150814,Attorney General,148289,2525
DeKalb,Election Day,140482,Attorney General,137310,3172
DeKalb,Provisional,1773,Attorney General,1708,65
Decatur,Absentee by Mail,548,Attorney General,539,9
Decatur,Advance in Person,4260,Attorney General,4132,128
Decatur,Election Day,4235,Attorney General,4128,107
Decatur,Provisional,103,Attorney General,98,5
Dodge,Absentee by Mail,448,Attorney General,431,17
Dodge,Advance in Person,3411,Attorney General,3277,134
Dodge,Election Day,3192,Attorney General,3040,152
Dodge,Provisional,10,Attorney General,10,0
Dooly,Absentee by Mail,196,Attorney General,191,5
Dooly,Advance in Person,1889,Attorney General,1815,74
Dooly,Election Day,1708,Attorney General,1655,53
Dooly,Provisional,2,Attorney General,1,1
Dougherty,Absentee by Mail,1944,Attorney General,1911,33
Dougherty,Advance in Person,11332,Attorney General,11112,220
Dougherty,Election Day,18021,Attorney General,17608,413
Dougherty,Provisional,128,Attorney General,123,5
Douglas,Absentee by Mail,3233,Attorney General,3192,41
Douglas,Advance in Person,30219,Attorney General,29834,385
Douglas,Election Day,21745,Attorney General,21369,376
Douglas,Provisional,58,Attorney General,58,0
Early,Absentee by Mail,473,Attorney General,459,14
Early,Advance in Person,1569,Attorney General,1541,28
Early,Election Day,2089,Attorney General,2041,48
Early,Provisional,4,Attorney General,4,0
Echols,Absentee by Mail,35,Attorney General,35,0
Echols,Advance in Person,767,Attorney General,741,26
Echols,Election Day,341,Attorney General,329,12
Echols,Provisional,0,Attorney General,0,0
Effingham,Absentee by Mail,750,Attorney General,737,13
Effingham,Advance in Person,10717,Attorney General,10528,189
Effingham,Election Day,11898,Attorney General,11686,212
Effingham,Provisional,6,Attorney General,6,0
Elbert,Absentee by Mail,563,Attorney General,559,4
Elbert,Advance in Person,3722,Attorney General,3640,82
Elbert,Election Day,3034,Attorney General,2940,94
Elbert,Provisional,69,Attorney General,67,2
Emanuel,Absentee by Mail,390,Attorney General,386,4
Emanuel,Advance in Person,3424,Attorney General,3320,104
Emanuel,Election Day,3896,Attorney General,3737,159
Emanuel,Provisional,6,Attorney General,6,0
Evans,Absentee by Mail,199,Attorney General,198,1
Evans,Advance in Person,2162,Attorney General,2071,91
Evans,Election Day,1086,Attorney General,1050,36
Evans,Provisional,0,Attorney General,0,0
Fannin,Absentee by Mail,658,Attorney General,650,8
Fannin,Advance in Person,5341,Attorney General,5235,106
Fannin,Election Day,5204,Attorney General,5049,155
Fannin,Provisional,16,Attorney General,16,0
Fayette,Absentee by Mail,2647,Attorney General,2594,53
Fayette,Advance in Person,31073,Attorney General,30636,437
Fayette,Election Day,24242,Attorney General,23756,486
Fayette,Provisional,36,Attorney General,35,1
Floyd,Absentee by Mail,1260,Attorney General,1243,17
Floyd,Advance in Person,13688,Attorney General,13449,239
Floyd,Election Day,15277,Attorney General,14888,389
Floyd,Provisional,113,Attorney General,109,4
Forsyth,Absentee by Mail,4428,Attorney General,4356,72
Forsyth,Advance in Person,52559,Attorney General,51942,617
Forsyth,Election Day,36252,Attorney General,35595,657
Forsyth,Provisional,59,Attorney General,59,0
Franklin,Absentee by Mail,388,Attorney General,384,4
Franklin,Advance in Person,3502,Attorney General,3448,54
Franklin,Election Day,4259,Attorney General,4157,102
Franklin,Provisional,0,Attorney General,0,0
Fulton,Absentee by Mail,17842,Attorney General,17437,405
Fulton,Advance in Person,224522,Attorney General,220764,3758
Fulton,Election Day,179442,Attorney General,175433,4009
Fulton,Provisional,1982,Attorney General,1890,92
Gilmer,Absentee by Mail,559,Attorney General,555,4
Gilmer,Advance in Person,6295,Attorney General,6167,128
Gilmer,Election Day,5617,Attorney General,5478,139
Gilmer,Provisional,39,Attorney General,37,2
Glascock,Absentee by Mail,81,Attorney General,79,2
Glascock,Advance in Person,652,Attorney General,623,29
Glascock,Election Day,567,Attorney General,535,32
Glascock,Provisional,1,Attorney General,1,0
Glynn,Absentee by Mail,1812,Attorney General,1794,18
Glynn,Advance in Person,17510,Attorney General,17194,316
Glynn,Election Day,13179,Attorney General,12875,304
Glynn,Provisional,147,Attorney General,142,5
Gordon,Absentee by Mail,547,Attorney General,533,14
Gordon,Advance in Person,8119,Attorney General,7926,193
Gordon,Election Day,9106,Attorney General,8904,202
Gordon,Provisional,32,Attorney General,32,0
Grady,Absentee by Mail,400,Attorney General,392,8
Grady,Advance in Person,3857,Attorney General,3790,67
Grady,Election Day,4099,Attorney General,4006,93
Grady,Provisional,14,Attorney General,14,0
Greene,Absentee by Mail,623,Attorney General,612,11
Greene,Advance in Person,5593,Attorney General,5526,67
Greene,Election Day,2773,Attorney General,2715,58
Greene,Provisional,6,Attorney General,6,0
Gwinnett,Absentee by Mail,20397,Attorney General,19988,409
Gwinnett,Advance in Person,137166,Attorney General,135497,1669
Gwinnett,Election Day,155146,Attorney General,152363,2783
Gwinnett,Provisional,2209,Attorney General,2129,80
Habersham,Absentee by Mail,853,Attorney General,840,13
Habersham,Advance in Person,10023,Attorney General,9837,186
Habersham,Election Day,4619,Attorney General,4502,117
Habersham,Provisional,5,Attorney General,5,0
Hall,Absentee by Mail,3493,Attorney General,3458,35
Hall,Advance in Person,24348,Attorney General,23929,419
Hall,Election Day,39441,Attorney General,38639,802
Hall,Provisional,124,Attorney General,119,5
Hancock,Absentee by Mail,490,Attorney General,470,20
Hancock,Advance in Person,1531,Attorney General,1469,62
Hancock,Election Day,1518,Attorney General,1441,77
Hancock,Provisional,9,Attorney General,8,1
Haralson,Absentee by Mail,393,Attorney General,390,3
Haralson,Advance in Person,4202,Attorney General,4127,75
Haralson,Election Day,5990,Attorney General,5872,118
Haralson,Provisional,0,Attorney General,0,0
Harris,Absentee by Mail,729,Attorney General,720,9
Harris,Advance in Person,7251,Attorney General,7144,107
Harris,Election Day,7992,Attorney General,7833,159
Harris,Provisional,14,Attorney General,14,0
Hart,Absentee by Mail,440,Attorney General,431,9
Hart,Advance in Person,5220,Attorney General,5068,152
Hart,Election Day,3958,Attorney General,3841,117
Hart,Provisional,4,Attorney General,4,0
Heard,Absentee by Mail,278,Attorney General,273,5
Heard,Advance in Person,1427,Attorney General,1396,31
Heard,Election Day,2346,Attorney General,2280,66
Heard,Provisional,4,Attorney General,4,0
Henry,Absentee by Mail,4997,Attorney General,4920,77
Henry,Advance in Person,58658,Attorney General,57791,867
Henry,Election Day,34710,Attorney General,34103,607
Henry,Provisional,193,Attorney General,187,6
Houston,Absentee by Mail,3190,Attorney General,3136,54
Houston,Advance in Person,34816,Attorney General,34334,482
Houston,Election Day,21152,Attorney General,20760,392
Houston,Provisional,74,Attorney General,70,4
Irwin,Absentee by Mail,133,Attorney General,133,0
Irwin,Advance in Person,2048,Attorney General,1988,60
Irwin,Election Day,1375,Attorney General,1346,29
Irwin,Provisional,8,Attorney General,8,0
Jackson,Absentee by Mail,1019,Attorney General,1006,13
Jackson,Advance in Person,14919,Attorney General,14691,228
Jackson,Election Day,10951,Attorney General,10749,202
Jackson,Provisional,10,Attorney General,10,0
Jasper,Absentee by Mail,421,Attorney General,415,6
Jasper,Advance in Person,2981,Attorney General,2925,56
Jasper,Election Day,2505,Attorney General,2450,55
Jasper,Provisional,38,Attorney General,37,1
Jeff Davis,Absentee by Mail,229,Attorney General,219,10
Jeff Davis,Advance in Person,2680,Attorney General,2577,103
Jeff Davis,Election Day,1906,Attorney General,1801,105
Jeff Davis,Provisional,0,Attorney General,0,0
Jefferson,Absentee by Mail,607,Attorney General,593,14
Jefferson,Advance in Person,2803,Attorney General,2686,117
Jefferson,Election Day,3346,Attorney General,3206,140
Jefferson,Provisional,11,Attorney General,11,0
Jenkins,Absentee by Mail,188,Attorney General,187,1
Jenkins,Advance in Person,1557,Attorney General,1508,49
Jenkins,Election Day,1111,Attorney General,1077,34
Jenkins,Provisional,16,Attorney General,16,0
Johnson,Absentee by Mail,236,Attorney General,225,11
Johnson,Advance in Person,1970,Attorney General,1900,70
Johnson,Election Day,1277,Attorney General,1224,53
Johnson,Provisional,0,Attorney General,0,0
Jones,Absentee by Mail,784,Attorney General,775,9
Jones,Advance in Person,6968,Attorney General,6836,132
Jones,Election Day,4680,Attorney General,4580,100
Jones,Provisional,9,Attorney General,9,0
Lamar,Absentee by Mail,404,Attorney General,400,4
Lamar,Advance in Person,3820,Attorney General,3740,80
Lamar,Election Day,3122,Attorney General,3062,60
Lamar,Provisional,11,Attorney General,11,0
Lanier,Absentee by Mail,108,Attorney General,105,3
Lanier,Advance in Person,1661,Attorney General,1603,58
Lanier,Election Day,910,Attorney General,859,51
Lanier,Provisional,2,Attorney General,2,0
Laurens,Absentee by Mail,1286,Attorney General,1259,27
Laurens,Advance in Person,8485,Attorney General,8221,264
Laurens,Election Day,9168,Attorney General,8903,265
Laurens,Provisional,13,Attorney General,13,0
Lee,Absentee by Mail,480,Attorney General,474,6
Lee,Advance in Person,5681,Attorney General,5584,97
Lee,Election Day,7388,Attorney General,7264,124
Lee,Provisional,6,Attorney General,6,0
Liberty,Absentee by Mail,950,Attorney General,941,9
Liberty,Advance in Person,8143,Attorney General,8002,141
Liberty,Election Day,6265,Attorney General,6143,122
Liberty,Provisional,10,Attorney General,9,1
Lincoln,Absentee by Mail,350,Attorney General,344,6
Lincoln,Advance in Person,1937,Attorney General,1894,43
Lincoln,Election Day,1680,Attorney General,1636,44
Lincoln,Provisional,2,Attorney General,2,0
Long,Absentee by Mail,169,Attorney General,167,2
Long,Advance in Person,1971,Attorney General,1906,65
Long,Election Day,1848,Attorney General,1775,73
Long,Provisional,10,Attorney General,10,0
Lowndes,Absentee by Mail,1890,Attorney General,1860,30
Lowndes,Advance in Person,21238,Attorney General,20936,302
Lowndes,Election Day,12084,Attorney General,11832,252
Lowndes,Provisional,541,Attorney General,517,24
Lumpkin,Absentee by Mail,467,Attorney General,463,4
Lumpkin,Advance in Person,7377,Attorney General,7265,112
Lumpkin,Election Day,3707,Attorney General,3613,94
Lumpkin,Provisional,7,Attorney General,7,0
Macon,Absentee by Mail,331,Attorney General,326,5
Macon,Advance in Person,2251,Attorney General,2140,111
Macon,Election Day,1635,Attorney General,1572,63
Macon,Provisional,0,Attorney General,0,0
Madison,Absentee by Mail,527,Attorney General,521,6
Madison,Advance in Person,5242,Attorney General,5103,139
Madison,Election Day,5928,Attorney General,5786,142
Madison,Provisional,2,Attorney General,2,0
Marion,Absentee by Mail,241,Attorney General,240,1
Marion,Advance in Person,1222,Attorney General,1175,47
Marion,Election Day,1467,Attorney General,1427,40
Marion,Provisional,1,Attorney General,1,0
McDuffie,Absentee by Mail,868,Attorney General,854,14
McDuffie,Advance in Person,5045,Attorney General,4948,97
McDuffie,Election Day,2879,Attorney General,2806,73
McDuffie,Provisional,0,Attorney General,0,0
McIntosh,Absentee by Mail,440,Attorney General,433,7
McIntosh,Advance in Person,2945,Attorney General,2879,66
McIntosh,Election Day,2023,Attorney General,1958,65
McIntosh,Provisional,0,Attorney General,0,0
Meriwether,Absentee by Mail,483,Attorney General,477,6
Meriwether,Advance in Person,2831,Attorney General,2767,64
Meriwether,Election Day,5325,Attorney General,5186,139
Meriwether,Provisional,11,Attorney General,10,1
Miller,Absentee by Mail,132,Attorney General,128,4
Miller,Advance in Person,1029,Attorney General,980,49
Miller,Election Day,1152,Attorney General,1106,46
Miller,Provisional,2,Attorney General,2,0
Mitchell,Absentee by Mail,564,Attorney General,558,6
Mitchell,Advance in Person,3343,Attorney General,3275,68
Mitchell,Election Day,3539,Attorney General,3458,81
Mitchell,Provisional,9,Attorney General,9,0
Monroe,Absentee by Mail,696,Attorney General,692,4
Monroe,Advance in Person,6311,Attorney General,6161,150
Monroe,Election Day,5925,Attorney General,5782,143
Monroe,Provisional,10,Attorney General,10,0
Montgomery,Absentee by Mail,211,Attorney General,203,8
Montgomery,Advance in Person,1416,Attorney General,1363,53
Montgomery,Election Day,1901,Attorney General,1831,70
Montgomery,Provisional,0,Attorney General,0,0
Morgan,Absentee by Mail,410,Attorney General,401,9
Morgan,Advance in Person,5406,Attorney General,5307,99
Morgan,Election Day,3738,Attorney General,3648,90
Morgan,Provisional,4,Attorney General,4,0
Murray,Absentee by Mail,265,Attorney General,257,8
Murray,Advance in Person,5111,Attorney General,4963,148
Murray,Election Day,5715,Attorney General,5531,184
Murray,Provisional,0,Attorney General,0,0
Muscogee,Absentee by Mail,4422,Attorney General,4369,53
Muscogee,Advance in Person,27700,Attorney General,27160,540
Muscogee,Election Day,31019,Attorney General,30369,650
Muscogee,Provisional,131,Attorney General,128,3
Newton,Absentee by Mail,2735,Attorney General,2700,35
Newton,Advance in Person,19236,Attorney General,18847,389
Newton,Election Day,21158,Attorney General,20764,394
Newton,Provisional,12,Attorney General,12,0
Oconee,Absentee by Mail,931,Attorney General,919,12
Oconee,Advance in Person,11688,Attorney General,11508,180
Oconee,Election Day,8114,Attorney General,7952,162
Oconee,Provisional,11,Attorney General,11,0
Oglethorpe,Absentee by Mail,409,Attorney General,405,4
Oglethorpe,Advance in Person,3417,Attorney General,3343,74
Oglethorpe,Election Day,2658,Attorney General,2581,77
Oglethorpe,Provisional,1,Attorney General,1,0
Paulding,Absentee by Mail,3307,Attorney General,3260,47
Paulding,Advance in Person,32842,Attorney General,32345,497
Paulding,Election Day,25073,Attorney General,24655,418
Paulding,Provisional,83,Attorney General,81,2
Peach,Absentee by Mail,445,Attorney General,438,7
Peach,Advance in Person,6720,Attorney General,6586,134
Peach,Election Day,3190,Attorney General,3118,72
Peach,Provisional,90,Attorney General,87,3
Pickens,Absentee by Mail,222,Attorney General,220,2
Pickens,Advance in Person,7121,Attorney General,6975,146
Pickens,Election Day,6019,Attorney General,5886,133
Pickens,Provisional,0,Attorney General,0,0
Pierce,Absentee by Mail,327,Attorney General,327,0
Pierce,Advance in Person,4598,Attorney General,4532,66
Pierce,Election Day,1958,Attorney General,1917,41
Pierce,Provisional,1,Attorney General,1,0
Pike,Absentee by Mail,304,Attorney General,301,3
Pike,Advance in Person,4478,Attorney General,4425,53
Pike,Election Day,3752,Attorney General,3669,83
Pike,Provisional,9,Attorney General,9,0
Polk,Absentee by Mail,447,Attorney General,443,4
Polk,Advance in Person,7744,Attorney General,7571,173
Polk,Election Day,4668,Attorney General,4554,114
Polk,Provisional,2,Attorney General,2,0
Pulaski,Absentee by Mail,232,Attorney General,224,8
Pulaski,Advance in Person,2522,Attorney General,2417,105
Pulaski,Election Day,868,Attorney General,826,42
Pulaski,Provisional,0,Attorney General,0,0
Putnam,Absentee by Mail,598,Attorney General,594,4
Putnam,Advance in Person,4858,Attorney General,4776,82
Putnam,Election Day,3865,Attorney General,3769,96
Putnam,Provisional,14,Attorney General,14,0
Quitman,Absentee by Mail,60,Attorney General,53,7
Quitman,Advance in Person,451,Attorney General,424,27
Quitman,Election Day,429,Attorney General,408,21
Quitman,Provisional,0,Attorney General,0,0
Rabun,Absentee by Mail,843,Attorney General,826,17
Rabun,Advance in Person,4889,Attorney General,4787,102
Rabun,Election Day,1846,Attorney General,1803,43
Rabun,Provisional,0,Attorney General,0,0
Randolph,Absentee by Mail,313,Attorney General,305,8
Randolph,Advance in Person,1232,Attorney General,1183,49
Randolph,Election Day,1243,Attorney General,1201,42
Randolph,Provisional,1,Attorney General,1,0
Richmond,Absentee by Mail,5314,Attorney General,5202,112
Richmond,Advance in Person,28737,Attorney General,28223,514
Richmond,Election Day,35992,Attorney General,35178,814
Richmond,Provisional,112,Attorney General,103,9
Rockdale,Absentee by Mail,1853,Attorney General,1822,31
Rockdale,Advance in Person,22789,Attorney General,22450,339
Rockdale,Election Day,11958,Attorney General,11722,236
Rockdale,Provisional,55,Attorney General,53,2
Schley,Absentee by Mail,96,Attorney General,96,0
Schley,Advance in Person,1321,Attorney General,1286,35
Schley,Election Day,514,Attorney General,490,24
Schley,Provisional,2,Attorney General,2,0
Screven,Absentee by Mail,271,Attorney General,261,10
Screven,Advance in Person,2674,Attorney General,2595,79
Screven,Election Day,2462,Attorney General,2362,100
Screven,Provisional,7,Attorney General,7,0
Seminole,Absentee by Mail,264,Attorney General,259,5
Seminole,Advance in Person,1078,Attorney General,1063,15
Seminole,Election Day,1872,Attorney General,1824,48
Seminole,Provisional,13,Attorney General,12,1
Spalding,Absentee by Mail,1283,Attorney General,1255,28
Spalding,Advance in Person,13046,Attorney General,12706,340
Spalding,Election Day,10056,Attorney General,9818,238
Spalding,Provisional,32,Attorney General,30,2
Stephens,Absentee by Mail,536,Attorney General,527,9
Stephens,Advance in Person,6139,Attorney General,6007,132
Stephens,Election Day,2394,Attorney General,2327,67
Stephens,Provisional,18,Attorney General,17,1
Stewart,Absentee by Mail,233,Attorney General,220,13
Stewart,Advance in Person,694,Attorney General,645,49
Stewart,Election Day,857,Attorney General,782,75
Stewart,Provisional,35,Attorney General,35,0
Sumter,Absentee by Mail,877,Attorney General,852,25
Sumter,Advance in Person,5531,Attorney General,5401,130
Sumter,Election Day,4148,Attorney General,4038,110
Sumter,Provisional,0,Attorney General,0,0
Talbot,Absentee by Mail,285,Attorney General,264,21
Talbot,Advance in Person,772,Attorney General,748,24
Talbot,Election Day,1895,Attorney General,1816,79
Talbot,Provisional,2,Attorney General,2,0
Taliaferro,Absentee by Mail,162,Attorney General,151,11
Taliaferro,Advance in Person,441,Attorney General,403,38
Taliaferro,Election Day,314,Attorney General,288,26
Taliaferro,Provisional,4,Attorney General,4,0
Tattnall,Absentee by Mail,392,Attorney General,387,5
Tattnall,Advance in Person,3539,Attorney General,3426,113
Tattnall,Election Day,2708,Attorney General,2611,97
Tattnall,Provisional,8,Attorney General,8,0
Taylor,Absentee by Mail,243,Attorney General,239,4
Taylor,Advance in Person,1843,Attorney General,1811,32
Taylor,Election Day,1179,Attorney General,1130,49
Taylor,Provisional,29,Attorney General,29,0
Telfair,Absentee by Mail,331,Attorney General,326,5
Telfair,Advance in Person,1676,Attorney General,1604,72
Telfair,Election Day,1624,Attorney General,1560,64
Telfair,Provisional,1,Attorney General,1,0
Terrell,Absentee by Mail,327,Attorney General,322,5
Terrell,Advance in Person,1612,Attorney General,1583,29
Terrell,Election Day,1991,Attorney General,1912,79
Terrell,Provisional,9,Attorney General,9,0
Thomas,Absentee by Mail,991,Attorney General,974,17
Thomas,Advance in Person,8376,Attorney General,8170,206
Thomas,Election Day,7874,Attorney General,7705,169
Thomas,Provisional,3,Attorney General,3,0
Tift,Absentee by Mail,561,Attorney General,545,16
Tift,Advance in Person,7646,Attorney General,7440,206
Tift,Election Day,5462,Attorney General,5295,167
Tift,Provisional,4,Attorney General,3,1
Toombs,Absentee by Mail,681,Attorney General,666,15
Toombs,Advance in Person,4860,Attorney General,4730,130
Toombs,Election Day,3310,Attorney General,3217,93
Toombs,Provisional,9,Attorney General,9,0
Towns,Absentee by Mail,284,Attorney General,282,2
Towns,Advance in Person,4009,Attorney General,3906,103
Towns,Election Day,1839,Attorney General,1794,45
Towns,Provisional,0,Attorney General,0,0
Treutlen,Absentee by Mail,146,Attorney General,139,7
Treutlen,Advance in Person,1659,Attorney General,1587,72
Treutlen,Election Day,805,Attorney General,761,44
Treutlen,Provisional,4,Attorney General,4,0
Troup,Absentee by Mail,1264,Attorney General,1242,22
Troup,Advance in Person,11226,Attorney General,11007,219
Troup,Election Day,11173,Attorney General,10904,269
Troup,Provisional,250,Attorney General,242,8
Turner,Absentee by Mail,148,Attorney General,148,0
Turner,Advance in Person,1922,Attorney General,1859,63
Turner,Election Day,1199,Attorney General,1165,34
Turner,Provisional,5,Attorney General,5,0
Twiggs,Absentee by Mail,275,Attorney General,273,2
Twiggs,Advance in Person,1531,Attorney General,1480,51
Twiggs,Election Day,1981,Attorney General,1909,72
Twiggs,Provisional,5,Attorney General,5,0
Union,Absentee by Mail,482,Attorney General,475,7
Union,Advance in Person,6626,Attorney General,6508,118
Union,Election Day,4755,Attorney General,4622,133
Union,Provisional,2,Attorney General,2,0
Upson,Absentee by Mail,602,Attorney General,597,5
Upson,Advance in Person,6729,Attorney General,6547,182
Upson,Election Day,3227,Attorney General,3140,87
Upson,Provisional,10,Attorney General,9,1
Walker,Absentee by Mail,813,Attorney General,800,13
Walker,Advance in Person,11133,Attorney General,10892,241
Walker,Election Day,9505,Attorney General,9255,250
Walker,Provisional,39,Attorney General,38,1
Walton,Absentee by Mail,1769,Attorney General,1748,21
Walton,Advance in Person,14370,Attorney General,14062,308
Walton,Election Day,22496,Attorney General,22089,407
Walton,Provisional,51,Attorney General,49,2
Ware,Absentee by Mail,627,Attorney General,619,8
Ware,Advance in Person,5460,Attorney General,5378,82
Ware,Election Day,4917,Attorney General,4779,138
Ware,Provisional,12,Attorney General,12,0
Warren,Absentee by Mail,187,Attorney General,185,2
Warren,Advance in Person,1267,Attorney General,1222,45
Warren,Election Day,806,Attorney General,774,32
Warren,Provisional,1,Attorney General,1,0
Washington,Absentee by Mail,727,Attorney General,705,22
Washington,Advance in Person,3907,Attorney General,3760,147
Washington,Election Day,3525,Attorney General,3377,148
Washington,Provisional,10,Attorney General,10,0
Wayne,Absentee by Mail,501,Attorney General,498,3
Wayne,Advance in Person,5868,Attorney General,5724,144
Wayne,Election Day,3753,Attorney General,3661,92
Wayne,Provisional,10,Attorney General,9,1
Webster,Absentee by Mail,152,Attorney General,149,3
Webster,Advance in Person,544,Attorney General,529,15
Webster,Election Day,404,Attorney General,383,21
Webster,Provisional,0,Attorney General,0,0
Wheeler,Absentee by Mail,115,Attorney General,115,0
Wheeler,Advance in Person,974,Attorney General,945,29
Wheeler,Election Day,838,Attorney General,797,41
Wheeler,Provisional,4,Attorney General,4,0
White,Absentee by Mail,537,Attorney General,534,3
White,Advance in Person,5408,Attorney General,5302,106
White,Election Day,5489,Attorney General,5413,76
White,Provisional,6,Attorney General,6,0
Whitfield,Absentee by Mail,1017,Attorney General,999,18
Whitfield,Advance in Person,9610,Attorney General,9373,237
Whitfield,Election Day,16675,Attorney General,16191,484
Whitfield,Provisional,25,Attorney General,24,1
Wilcox,Absentee by Mail,205,Attorney General,198,7
Wilcox,Advance in Person,1202,Attorney General,1178,24
Wilcox,Election Day,1408,Attorney General,1358,50
Wilcox,Provisional,0,Attorney General,0,0
Wilkes,Absentee by Mail,301,Attorney General,292,9
Wilkes,Advance in Person,2075,Attorney General,2000,75
Wilkes,Election Day,1995,Attorney General,1917,78
Wilkes,Provisional,6,Attorney General,6,0
Wilkinson,Absentee by Mail,270,Attorney General,260,10
Wilkinson,Advance in Person,1567,Attorney General,1519,48
Wilkinson,Election Day,2427,Attorney General,2338,89
Wilkinson,Provisional,1,Attorney General,1,0
Worth,Absentee by Mail,305,Attorney General,300,5
Worth,Advance in Person,3108,Attorney General,3029,79
Worth,Election Day,4418,Attorney General,4296,122
Worth,Provisional,15,Attorney General,15,0
Appling,Absentee by Mail,530,Commissioner Of Agriculture,517,13
Appling,Advance in Person,3298,Commissioner Of Agriculture,3193,105
Appling,Election Day,2978,Commissioner Of Agriculture,2864,114
Appling,Provisional,3,Commissioner Of Agriculture,3,0
Atkinson,Absentee by Mail,88,Commissioner Of Agriculture,87,1
Atkinson,Advance in Person,1285,Commissioner Of Agriculture,1225,60
Atkinson,Election Day,1147,Commissioner Of Agriculture,1091,56
Atkinson,Provisional,2,Commissioner Of Agriculture,2,0
Bacon,Absentee by Mail,174,Commissioner Of Agriculture,172,2
Bacon,Advance in Person,2828,Commissioner Of Agriculture,2759,69
Bacon,Election Day,827,Commissioner Of Agriculture,782,45
Bacon,Provisional,1,Commissioner Of Agriculture,1,0
Baker,Absentee by Mail,141,Commissioner Of Agriculture,134,7
Baker,Advance in Person,485,Commissioner Of Agriculture,471,14
Baker,Election Day,665,Commissioner Of Agriculture,635,30
Baker,Provisional,2,Commissioner Of Agriculture,2,0
Baldwin,Absentee by Mail,1158,Commissioner Of Agriculture,1141,17
Baldwin,Advance in Person,8295,Commissioner Of Agriculture,8045,250
Baldwin,Election Day,6180,Commissioner Of Agriculture,5949,231
Baldwin,Provisional,3,Commissioner Of Agriculture,3,0
Banks,Absentee by Mail,223,Commissioner Of Agriculture,223,0
Banks,Advance in Person,2771,Commissioner Of Agriculture,2733,38
Banks,Election Day,3858,Commissioner Of Agriculture,3801,57
Banks,Provisional,1,Commissioner Of Agriculture,1,0
Barrow,Absentee by Mail,1263,Commissioner Of Agriculture,1246,17
Barrow,Advance in Person,12223,Commissioner Of Agriculture,11975,248
Barrow,Election Day,13912,Commissioner Of Agriculture,13617,295
Barrow,Provisional,7,Commissioner Of Agriculture,7,0
Bartow,Absentee by Mail,1568,Commissioner Of Agriculture,1543,25
Bartow,Advance in Person,16175,Commissioner Of Agriculture,15927,248
Bartow,Election Day,19584,Commissioner Of Agriculture,19226,358
Bartow,Provisional,32,Commissioner Of Agriculture,32,0
Ben Hill,Absentee by Mail,320,Commissioner Of Agriculture,315,5
Ben Hill,Advance in Person,3605,Commissioner Of Agriculture,3539,66
Ben Hill,Election Day,1608,Commissioner Of Agriculture,1573,35
Ben Hill,Provisional,14,Commissioner Of Agriculture,14,0
Berrien,Absentee by Mail,322,Commissioner Of Agriculture,319,3
Berrien,Advance in Person,3153,Commissioner Of Agriculture,3077,76
Berrien,Election Day,2772,Commissioner Of Agriculture,2692,80
Berrien,Provisional,5,Commissioner Of Agriculture,5,0
Bibb,Absentee by Mail,4461,Commissioner Of Agriculture,4382,79
Bibb,Advance in Person,26183,Commissioner Of Agriculture,25489,694
Bibb,Election Day,29816,Commissioner Of Agriculture,29026,790
Bibb,Provisional,232,Commissioner Of Agriculture,225,7
Bleckley,Absentee by Mail,257,Commissioner Of Agriculture,250,7
Bleckley,Advance in Person,2805,Commissioner Of Agriculture,2725,80
Bleckley,Election Day,1793,Commissioner Of Agriculture,1736,57
Bleckley,Provisional,5,Commissioner Of Agriculture,5,0
Brantley,Absentee by Mail,188,Commissioner Of Agriculture,185,3
Brantley,Advance in Person,2868,Commissioner Of Agriculture,2807,61
Brantley,Election Day,2633,Commissioner Of Agriculture,2543,90
Brantley,Provisional,5,Commissioner Of Agriculture,5,0
Brooks,Absentee by Mail,465,Commissioner Of Agriculture,454,11
Brooks,Advance in Person,2417,Commissioner Of Agriculture,2361,56
Brooks,Election Day,2814,Commissioner Of Agriculture,2742,72
Brooks,Provisional,27,Commissioner Of Agriculture,27,0
Bryan,Absentee by Mail,582,Commissioner Of Agriculture,571,11
Bryan,Advance in Person,8342,Commissioner Of Agriculture,8161,181
Bryan,Election Day,6046,Commissioner Of Agriculture,5894,152
Bryan,Provisional,15,Commissioner Of Agriculture,15,0
Bulloch,Absentee by Mail,1076,Commissioner Of Agriculture,1049,27
Bulloch,Advance in Person,11170,Commissioner Of Agriculture,10897,273
Bulloch,Election Day,11297,Commissioner Of Agriculture,10989,308
Bulloch,Provisional,140,Commissioner Of Agriculture,132,8
Burke,Absentee by Mail,968,Commissioner Of Agriculture,958,10
Burke,Advance in Person,3199,Commissioner Of Agriculture,3102,97
Burke,Election Day,4552,Commissioner Of Agriculture,4388,164
Burke,Provisional,2,Commissioner Of Agriculture,2,0
Butts,Absentee by Mail,380,Commissioner Of Agriculture,369,11
Butts,Advance in Person,6277,Commissioner Of Agriculture,6116,161
Butts,Election Day,2206,Commissioner Of Agriculture,2147,59
Butts,Provisional,0,Commissioner Of Agriculture,0,0
Calhoun,Absentee by Mail,185,Commissioner Of Agriculture,183,2
Calhoun,Advance in Person,607,Commissioner Of Agriculture,593,14
Calhoun,Election Day,1107,Commissioner Of Agriculture,1066,41
Calhoun,Provisional,0,Commissioner Of Agriculture,0,0
Camden,Absentee by Mail,1193,Commissioner Of Agriculture,1176,17
Camden,Advance in Person,8085,Commissioner Of Agriculture,7919,166
Camden,Election Day,7775,Commissioner Of Agriculture,7570,205
Camden,Provisional,8,Commissioner Of Agriculture,8,0
Candler,Absentee by Mail,120,Commissioner Of Agriculture,117,3
Candler,Advance in Person,2335,Commissioner Of Agriculture,2271,64
Candler,Election Day,1083,Commissioner Of Agriculture,1054,29
Candler,Provisional,1,Commissioner Of Agriculture,1,0
Carroll,Absentee by Mail,1518,Commissioner Of Agriculture,1488,30
Carroll,Advance in Person,20100,Commissioner Of Agriculture,19701,399
Carroll,Election Day,20121,Commissioner Of Agriculture,19648,473
Carroll,Provisional,104,Commissioner Of Agriculture,101,3
Catoosa,Absentee by Mail,540,Commissioner Of Agriculture,535,5
Catoosa,Advance in Person,13673,Commissioner Of Agriculture,13407,266
Catoosa,Election Day,9512,Commissioner Of Agriculture,9323,189
Catoosa,Provisional,33,Commissioner Of Agriculture,33,0
Charlton,Absentee by Mail,163,Commissioner Of Agriculture,158,5
Charlton,Advance in Person,1549,Commissioner Of Agriculture,1514,35
Charlton,Election Day,1657,Commissioner Of Agriculture,1584,73
Charlton,Provisional,8,Commissioner Of Agriculture,8,0
Chatham,Absentee by Mail,6177,Commissioner Of Agriculture,6049,128
Chatham,Advance in Person,32338,Commissioner Of Agriculture,31528,810
Chatham,Election Day,64823,Commissioner Of Agriculture,62821,2002
Chatham,Provisional,205,Commissioner Of Agriculture,195,10
Chattahoochee,Absentee by Mail,35,Commissioner Of Agriculture,35,0
Chattahoochee,Advance in Person,493,Commissioner Of Agriculture,466,27
Chattahoochee,Election Day,574,Commissioner Of Agriculture,551,23
Chattahoochee,Provisional,3,Commissioner Of Agriculture,3,0
Chattooga,Absentee by Mail,225,Commissioner Of Agriculture,224,1
Chattooga,Advance in Person,3452,Commissioner Of Agriculture,3363,89
Chattooga,Election Day,3750,Commissioner Of Agriculture,3643,107
Chattooga,Provisional,7,Commissioner Of Agriculture,7,0
Cherokee,Absentee by Mail,5312,Commissioner Of Agriculture,5200,112
Cherokee,Advance in Person,48565,Commissioner Of Agriculture,47762,803
Cherokee,Election Day,52422,Commissioner Of Agriculture,51043,1379
Cherokee,Provisional,112,Commissioner Of Agriculture,107,5
Clarke,Absentee by Mail,3022,Commissioner Of Agriculture,2968,54
Clarke,Advance in Person,19957,Commissioner Of Agriculture,19518,439
Clarke,Election Day,20282,Commissioner Of Agriculture,19609,673
Clarke,Provisional,41,Commissioner Of Agriculture,40,1
Clay,Absentee by Mail,143,Commissioner Of Agriculture,140,3
Clay,Advance in Person,579,Commissioner Of Agriculture,549,30
Clay,Election Day,464,Commissioner Of Agriculture,445,19
Clay,Provisional,0,Commissioner Of Agriculture,0,0
Clayton,Absentee by Mail,5847,Commissioner Of Agriculture,5719,128
Clayton,Advance in Person,47671,Commissioner Of Agriculture,46640,1031
Clayton,Election Day,38322,Commissioner Of Agriculture,37295,1027
Clayton,Provisional,372,Commissioner Of Agriculture,355,17
Clinch,Absentee by Mail,109,Commissioner Of Agriculture,109,0
Clinch,Advance in Person,1236,Commissioner Of Agriculture,1198,38
Clinch,Election Day,909,Commissioner Of Agriculture,868,41
Clinch,Provisional,4,Commissioner Of Agriculture,4,0
Cobb,Absentee by Mail,25901,Commissioner Of Agriculture,25408,493
Cobb,Advance in Person,111554,Commissioner Of Agriculture,109697,1857
Cobb,Election Day,172926,Commissioner Of Agriculture,168824,4102
Cobb,Provisional,1433,Commissioner Of Agriculture,1392,41
Coffee,Absentee by Mail,395,Commissioner Of Agriculture,388,7
Coffee,Advance in Person,7664,Commissioner Of Agriculture,7407,257
Coffee,Election Day,4536,Commissioner Of Agriculture,4394,142
Coffee,Provisional,20,Commissioner Of Agriculture,18,2
Colquitt,Absentee by Mail,514,Commissioner Of Agriculture,506,8
Colquitt,Advance in Person,6071,Commissioner Of Agriculture,5896,175
Colquitt,Election Day,6368,Commissioner Of Agriculture,6136,232
Colquitt,Provisional,10,Commissioner Of Agriculture,10,0
Columbia,Absentee by Mail,2936,Commissioner Of Agriculture,2871,65
Columbia,Advance in Person,29686,Commissioner Of Agriculture,29208,478
Columbia,Election Day,28969,Commissioner Of Agriculture,28327,642
Columbia,Provisional,43,Commissioner Of Agriculture,42,1
Cook,Absentee by Mail,244,Commissioner Of Agriculture,241,3
Cook,Advance in Person,3069,Commissioner Of Agriculture,3005,64
Cook,Election Day,2490,Commissioner Of Agriculture,2442,48
Cook,Provisional,0,Commissioner Of Agriculture,0,0
Coweta,Absentee by Mail,2812,Commissioner Of Agriculture,2772,40
Coweta,Advance in Person,25641,Commissioner Of Agriculture,25174,467
Coweta,Election Day,29603,Commissioner Of Agriculture,28891,712
Coweta,Provisional,15,Commissioner Of Agriculture,15,0
Crawford,Absentee by Mail,234,Commissioner Of Agriculture,230,4
Crawford,Advance in Person,2567,Commissioner Of Agriculture,2467,100
Crawford,Election Day,2130,Commissioner Of Agriculture,2084,46
Crawford,Provisional,3,Commissioner Of Agriculture,3,0
Crisp,Absentee by Mail,363,Commissioner Of Agriculture,353,10
Crisp,Advance in Person,4191,Commissioner Of Agriculture,4069,122
Crisp,Election Day,2470,Commissioner Of Agriculture,2353,117
Crisp,Provisional,26,Commissioner Of Agriculture,24,2
Dade,Absentee by Mail,129,Commissioner Of Agriculture,120,9
Dade,Advance in Person,2561,Commissioner Of Agriculture,2460,101
Dade,Election Day,2760,Commissioner Of Agriculture,2667,93
Dade,Provisional,12,Commissioner Of Agriculture,12,0
Dawson,Absentee by Mail,439,Commissioner Of Agriculture,432,7
Dawson,Advance in Person,7020,Commissioner Of Agriculture,6896,124
Dawson,Election Day,4111,Commissioner Of Agriculture,4004,107
Dawson,Provisional,11,Commissioner Of Agriculture,11,0
DeKalb,Absentee by Mail,19672,Commissioner Of Agriculture,19145,527
DeKalb,Advance in Person,150814,Commissioner Of Agriculture,147448,3366
DeKalb,Election Day,140482,Commissioner Of Agriculture,136125,4357
DeKalb,Provisional,1773,Commissioner Of Agriculture,1703,70
Decatur,Absentee by Mail,548,Commissioner Of Agriculture,538,10
Decatur,Advance in Person,4260,Commissioner Of Agriculture,4164,96
Decatur,Election Day,4235,Commissioner Of Agriculture,4107,128
Decatur,Provisional,103,Commissioner Of Agriculture,97,6
Dodge,Absentee by Mail,448,Commissioner Of Agriculture,433,15
Dodge,Advance in Person,3411,Commissioner Of Agriculture,3259,152
Dodge,Election Day,3192,Commissioner Of Agriculture,3049,143
Dodge,Provisional,10,Commissioner Of Agriculture,10,0
Dooly,Absentee by Mail,196,Commissioner Of Agriculture,192,4
Dooly,Advance in Person,1889,Commissioner Of Agriculture,1807,82
Dooly,Election Day,1708,Commissioner Of Agriculture,1635,73
Dooly,Provisional,2,Commissioner Of Agriculture,1,1
Dougherty,Absentee by Mail,1944,Commissioner Of Agriculture,1897,47
Dougherty,Advance in Person,11332,Commissioner Of Agriculture,11054,278
Dougherty,Election Day,18021,Commissioner Of Agriculture,17489,532
Dougherty,Provisional,128,Commissioner Of Agriculture,122,6
Douglas,Absentee by Mail,3233,Commissioner Of Agriculture,3182,51
Douglas,Advance in Person,30219,Commissioner Of Agriculture,29765,454
Douglas,Election Day,21745,Commissioner Of Agriculture,21260,485
Douglas,Provisional,58,Commissioner Of Agriculture,58,0
Early,Absentee by Mail,473,Commissioner Of Agriculture,459,14
Early,Advance in Person,1569,Commissioner Of Agriculture,1548,21
Early,Election Day,2089,Commissioner Of Agriculture,2030,59
Early,Provisional,4,Commissioner Of Agriculture,4,0
Echols,Absentee by Mail,35,Commissioner Of Agriculture,35,0
Echols,Advance in Person,767,Commissioner Of Agriculture,754,13
Echols,Election Day,341,Commissioner Of Agriculture,329,12
Echols,Provisional,0,Commissioner Of Agriculture,0,0
Effingham,Absentee by Mail,750,Commissioner Of Agriculture,739,11
Effingham,Advance in Person,10717,Commissioner Of Agriculture,10518,199
Effingham,Election Day,11898,Commissioner Of Agriculture,11637,261
Effingham,Provisional,6,Commissioner Of Agriculture,6,0
Elbert,Absentee by Mail,563,Commissioner Of Agriculture,560,3
Elbert,Advance in Person,3722,Commissioner Of Agriculture,3626,96
Elbert,Election Day,3034,Commissioner Of Agriculture,2937,97
Elbert,Provisional,69,Commissioner Of Agriculture,64,5
Emanuel,Absentee by Mail,390,Commissioner Of Agriculture,387,3
Emanuel,Advance in Person,3424,Commissioner Of Agriculture,3309,115
Emanuel,Election Day,3896,Commissioner Of Agriculture,3707,189
Emanuel,Provisional,6,Commissioner Of Agriculture,6,0
Evans,Absentee by Mail,199,Commissioner Of Agriculture,195,4
Evans,Advance in Person,2162,Commissioner Of Agriculture,2073,89
Evans,Election Day,1086,Commissioner Of Agriculture,1042,44
Evans,Provisional,0,Commissioner Of Agriculture,0,0
Fannin,Absentee by Mail,658,Commissioner Of Agriculture,650,8
Fannin,Advance in Person,5341,Commissioner Of Agriculture,5227,114
Fannin,Election Day,5204,Commissioner Of Agriculture,5023,181
Fannin,Provisional,16,Commissioner Of Agriculture,16,0
Fayette,Absentee by Mail,2647,Commissioner Of Agriculture,2589,58
Fayette,Advance in Person,31073,Commissioner Of Agriculture,30522,551
Fayette,Election Day,24242,Commissioner Of Agriculture,23572,670
Fayette,Provisional,36,Commissioner Of Agriculture,35,1
Floyd,Absentee by Mail,1260,Commissioner Of Agriculture,1227,33
Floyd,Advance in Person,13688,Commissioner Of Agriculture,13376,312
Floyd,Election Day,15277,Commissioner Of Agriculture,14807,470
Floyd,Provisional,113,Commissioner Of Agriculture,109,4
Forsyth,Absentee by Mail,4428,Commissioner Of Agriculture,4331,97
Forsyth,Advance in Person,52559,Commissioner Of Agriculture,51681,878
Forsyth,Election Day,36252,Commissioner Of Agriculture,35336,916
Forsyth,Provisional,59,Commissioner Of Agriculture,58,1
Franklin,Absentee by Mail,388,Commissioner Of Agriculture,386,2
Franklin,Advance in Person,3502,Commissioner Of Agriculture,3445,57
Franklin,Election Day,4259,Commissioner Of Agriculture,4145,114
Franklin,Provisional,0,Commissioner Of Agriculture,0,0
Fulton,Absentee by Mail,17842,Commissioner Of Agriculture,17268,574
Fulton,Advance in Person,224522,Commissioner Of Agriculture,219398,5124
Fulton,Election Day,179442,Commissioner Of Agriculture,173718,5724
Fulton,Provisional,1982,Commissioner Of Agriculture,1879,103
Gilmer,Absentee by Mail,559,Commissioner Of Agriculture,556,3
Gilmer,Advance in Person,6295,Commissioner Of Agriculture,6140,155
Gilmer,Election Day,5617,Commissioner Of Agriculture,5470,147
Gilmer,Provisional,39,Commissioner Of Agriculture,36,3
Glascock,Absentee by Mail,81,Commissioner Of Agriculture,80,1
Glascock,Advance in Person,652,Commissioner Of Agriculture,630,22
Glascock,Election Day,567,Commissioner Of Agriculture,533,34
Glascock,Provisional,1,Commissioner Of Agriculture,1,0
Glynn,Absentee by Mail,1812,Commissioner Of Agriculture,1782,30
Glynn,Advance in Person,17510,Commissioner Of Agriculture,17079,431
Glynn,Election Day,13179,Commissioner Of Agriculture,12796,383
Glynn,Provisional,147,Commissioner Of Agriculture,141,6
Gordon,Absentee by Mail,547,Commissioner Of Agriculture,536,11
Gordon,Advance in Person,8119,Commissioner Of Agriculture,7920,199
Gordon,Election Day,9106,Commissioner Of Agriculture,8882,224
Gordon,Provisional,32,Commissioner Of Agriculture,30,2
Grady,Absentee by Mail,400,Commissioner Of Agriculture,395,5
Grady,Advance in Person,3857,Commissioner Of Agriculture,3772,85
Grady,Election Day,4099,Commissioner Of Agriculture,3992,107
Grady,Provisional,14,Commissioner Of Agriculture,14,0
Greene,Absentee by Mail,623,Commissioner Of Agriculture,611,12
Greene,Advance in Person,5593,Commissioner Of Agriculture,5516,77
Greene,Election Day,2773,Commissioner Of Agriculture,2691,82
Greene,Provisional,6,Commissioner Of Agriculture,6,0
Gwinnett,Absentee by Mail,20397,Commissioner Of Agriculture,20115,282
Gwinnett,Advance in Person,137166,Commissioner Of Agriculture,134778,2388
Gwinnett,Election Day,155146,Commissioner Of Agriculture,151507,3639
Gwinnett,Provisional,2209,Commissioner Of Agriculture,2162,47
Habersham,Absentee by Mail,853,Commissioner Of Agriculture,837,16
Habersham,Advance in Person,10023,Commissioner Of Agriculture,9829,194
Habersham,Election Day,4619,Commissioner Of Agriculture,4490,129
Habersham,Provisional,5,Commissioner Of Agriculture,5,0
Hall,Absentee by Mail,3493,Commissioner Of Agriculture,3440,53
Hall,Advance in Person,24348,Commissioner Of Agriculture,23858,490
Hall,Election Day,39441,Commissioner Of Agriculture,38421,1020
Hall,Provisional,124,Commissioner Of Agriculture,118,6
Hancock,Absentee by Mail,490,Commissioner Of Agriculture,476,14
Hancock,Advance in Person,1531,Commissioner Of Agriculture,1452,79
Hancock,Election Day,1518,Commissioner Of Agriculture,1430,88
Hancock,Provisional,9,Commissioner Of Agriculture,7,2
Haralson,Absentee by Mail,393,Commissioner Of Agriculture,387,6
Haralson,Advance in Person,4202,Commissioner Of Agriculture,4115,87
Haralson,Election Day,5990,Commissioner Of Agriculture,5860,130
Haralson,Provisional,0,Commissioner Of Agriculture,0,0
Harris,Absentee by Mail,729,Commissioner Of Agriculture,717,12
Harris,Advance in Person,7251,Commissioner Of Agriculture,7108,143
Harris,Election Day,7992,Commissioner Of Agriculture,7777,215
Harris,Provisional,14,Commissioner Of Agriculture,14,0
Hart,Absentee by Mail,440,Commissioner Of Agriculture,430,10
Hart,Advance in Person,5220,Commissioner Of Agriculture,5055,165
Hart,Election Day,3958,Commissioner Of Agriculture,3825,133
Hart,Provisional,4,Commissioner Of Agriculture,4,0
Heard,Absentee by Mail,278,Commissioner Of Agriculture,273,5
Heard,Advance in Person,1427,Commissioner Of Agriculture,1388,39
Heard,Election Day,2346,Commissioner Of Agriculture,2281,65
Heard,Provisional,4,Commissioner Of Agriculture,4,0
Henry,Absentee by Mail,4997,Commissioner Of Agriculture,4886,111
Henry,Advance in Person,58658,Commissioner Of Agriculture,57563,1095
Henry,Election Day,34710,Commissioner Of Agriculture,33905,805
Henry,Provisional,193,Commissioner Of Agriculture,188,5
Houston,Absentee by Mail,3190,Commissioner Of Agriculture,3125,65
Houston,Advance in Person,34816,Commissioner Of Agriculture,34236,580
Houston,Election Day,21152,Commissioner Of Agriculture,20687,465
Houston,Provisional,74,Commissioner Of Agriculture,70,4
Irwin,Absentee by Mail,133,Commissioner Of Agriculture,132,1
Irwin,Advance in Person,2048,Commissioner Of Agriculture,1989,59
Irwin,Election Day,1375,Commissioner Of Agriculture,1342,33
Irwin,Provisional,8,Commissioner Of Agriculture,8,0
Jackson,Absentee by Mail,1019,Commissioner Of Agriculture,1009,10
Jackson,Advance in Person,14919,Commissioner Of Agriculture,14706,213
Jackson,Election Day,10951,Commissioner Of Agriculture,10743,208
Jackson,Provisional,10,Commissioner Of Agriculture,9,1
Jasper,Absentee by Mail,421,Commissioner Of Agriculture,417,4
Jasper,Advance in Person,2981,Commissioner Of Agriculture,2929,52
Jasper,Election Day,2505,Commissioner Of Agriculture,2447,58
Jasper,Provisional,38,Commissioner Of Agriculture,37,1
Jeff Davis,Absentee by Mail,229,Commissioner Of Agriculture,223,6
Jeff Davis,Advance in Person,2680,Commissioner Of Agriculture,2586,94
Jeff Davis,Election Day,1906,Commissioner Of Agriculture,1836,70
Jeff Davis,Provisional,0,Commissioner Of Agriculture,0,0
Jefferson,Absentee by Mail,607,Commissioner Of Agriculture,597,10
Jefferson,Advance in Person,2803,Commissioner Of Agriculture,2678,125
Jefferson,Election Day,3346,Commissioner Of Agriculture,3184,162
Jefferson,Provisional,11,Commissioner Of Agriculture,11,0
Jenkins,Absentee by Mail,188,Commissioner Of Agriculture,181,7
Jenkins,Advance in Person,1557,Commissioner Of Agriculture,1507,50
Jenkins,Election Day,1111,Commissioner Of Agriculture,1080,31
Jenkins,Provisional,16,Commissioner Of Agriculture,16,0
Johnson,Absentee by Mail,236,Commissioner Of Agriculture,224,12
Johnson,Advance in Person,1970,Commissioner Of Agriculture,1888,82
Johnson,Election Day,1277,Commissioner Of Agriculture,1211,66
Johnson,Provisional,0,Commissioner Of Agriculture,0,0
Jones,Absentee by Mail,784,Commissioner Of Agriculture,773,11
Jones,Advance in Person,6968,Commissioner Of Agriculture,6812,156
Jones,Election Day,4680,Commissioner Of Agriculture,4572,108
Jones,Provisional,9,Commissioner Of Agriculture,9,0
Lamar,Absentee by Mail,404,Commissioner Of Agriculture,400,4
Lamar,Advance in Person,3820,Commissioner Of Agriculture,3728,92
Lamar,Election Day,3122,Commissioner Of Agriculture,3034,88
Lamar,Provisional,11,Commissioner Of Agriculture,11,0
Lanier,Absentee by Mail,108,Commissioner Of Agriculture,105,3
Lanier,Advance in Person,1661,Commissioner Of Agriculture,1601,60
Lanier,Election Day,910,Commissioner Of Agriculture,862,48
Lanier,Provisional,2,Commissioner Of Agriculture,2,0
Laurens,Absentee by Mail,1286,Commissioner Of Agriculture,1253,33
Laurens,Advance in Person,8485,Commissioner Of Agriculture,8239,246
Laurens,Election Day,9168,Commissioner Of Agriculture,8876,292
Laurens,Provisional,13,Commissioner Of Agriculture,13,0
Lee,Absentee by Mail,480,Commissioner Of Agriculture,472,8
Lee,Advance in Person,5681,Commissioner Of Agriculture,5571,110
Lee,Election Day,7388,Commissioner Of Agriculture,7232,156
Lee,Provisional,6,Commissioner Of Agriculture,6,0
Liberty,Absentee by Mail,950,Commissioner Of Agriculture,937,13
Liberty,Advance in Person,8143,Commissioner Of Agriculture,7986,157
Liberty,Election Day,6265,Commissioner Of Agriculture,6116,149
Liberty,Provisional,10,Commissioner Of Agriculture,9,1
Lincoln,Absentee by Mail,350,Commissioner Of Agriculture,348,2
Lincoln,Advance in Person,1937,Commissioner Of Agriculture,1883,54
Lincoln,Election Day,1680,Commissioner Of Agriculture,1618,62
Lincoln,Provisional,2,Commissioner Of Agriculture,2,0
Long,Absentee by Mail,169,Commissioner Of Agriculture,167,2
Long,Advance in Person,1971,Commissioner Of Agriculture,1909,62
Long,Election Day,1848,Commissioner Of Agriculture,1785,63
Long,Provisional,10,Commissioner Of Agriculture,10,0
Lowndes,Absentee by Mail,1890,Commissioner Of Agriculture,1863,27
Lowndes,Advance in Person,21238,Commissioner Of Agriculture,20906,332
Lowndes,Election Day,12084,Commissioner Of Agriculture,11787,297
Lowndes,Provisional,541,Commissioner Of Agriculture,520,21
Lumpkin,Absentee by Mail,467,Commissioner Of Agriculture,461,6
Lumpkin,Advance in Person,7377,Commissioner Of Agriculture,7250,127
Lumpkin,Election Day,3707,Commissioner Of Agriculture,3608,99
Lumpkin,Provisional,7,Commissioner Of Agriculture,7,0
Macon,Absentee by Mail,331,Commissioner Of Agriculture,323,8
Macon,Advance in Person,2251,Commissioner Of Agriculture,2123,128
Macon,Election Day,1635,Commissioner Of Agriculture,1557,78
Macon,Provisional,0,Commissioner Of Agriculture,0,0
Madison,Absentee by Mail,527,Commissioner Of Agriculture,521,6
Madison,Advance in Person,5242,Commissioner Of Agriculture,5115,127
Madison,Election Day,5928,Commissioner Of Agriculture,5772,156
Madison,Provisional,2,Commissioner Of Agriculture,2,0
Marion,Absentee by Mail,241,Commissioner Of Agriculture,239,2
Marion,Advance in Person,1222,Commissioner Of Agriculture,1178,44
Marion,Election Day,1467,Commissioner Of Agriculture,1415,52
Marion,Provisional,1,Commissioner Of Agriculture,1,0
McDuffie,Absentee by Mail,868,Commissioner Of Agriculture,858,10
McDuffie,Advance in Person,5045,Commissioner Of Agriculture,4923,122
McDuffie,Election Day,2879,Commissioner Of Agriculture,2795,84
McDuffie,Provisional,0,Commissioner Of Agriculture,0,0
McIntosh,Absentee by Mail,440,Commissioner Of Agriculture,433,7
McIntosh,Advance in Person,2945,Commissioner Of Agriculture,2851,94
McIntosh,Election Day,2023,Commissioner Of Agriculture,1943,80
McIntosh,Provisional,0,Commissioner Of Agriculture,0,0
Meriwether,Absentee by Mail,483,Commissioner Of Agriculture,476,7
Meriwether,Advance in Person,2831,Commissioner Of Agriculture,2761,70
Meriwether,Election Day,5325,Commissioner Of Agriculture,5138,187
Meriwether,Provisional,11,Commissioner Of Agriculture,11,0
Miller,Absentee by Mail,132,Commissioner Of Agriculture,128,4
Miller,Advance in Person,1029,Commissioner Of Agriculture,980,49
Miller,Election Day,1152,Commissioner Of Agriculture,1103,49
Miller,Provisional,2,Commissioner Of Agriculture,2,0
Mitchell,Absentee by Mail,564,Commissioner Of Agriculture,550,14
Mitchell,Advance in Person,3343,Commissioner Of Agriculture,3252,91
Mitchell,Election Day,3539,Commissioner Of Agriculture,3443,96
Mitchell,Provisional,9,Commissioner Of Agriculture,9,0
Monroe,Absentee by Mail,696,Commissioner Of Agriculture,692,4
Monroe,Advance in Person,6311,Commissioner Of Agriculture,6152,159
Monroe,Election Day,5925,Commissioner Of Agriculture,5763,162
Monroe,Provisional,10,Commissioner Of Agriculture,10,0
Montgomery,Absentee by Mail,211,Commissioner Of Agriculture,206,5
Montgomery,Advance in Person,1416,Commissioner Of Agriculture,1375,41
Montgomery,Election Day,1901,Commissioner Of Agriculture,1842,59
Montgomery,Provisional,0,Commissioner Of Agriculture,0,0
Morgan,Absentee by Mail,410,Commissioner Of Agriculture,400,10
Morgan,Advance in Person,5406,Commissioner Of Agriculture,5282,124
Morgan,Election Day,3738,Commissioner Of Agriculture,3659,79
Morgan,Provisional,4,Commissioner Of Agriculture,4,0
Murray,Absentee by Mail,265,Commissioner Of Agriculture,260,5
Murray,Advance in Person,5111,Commissioner Of Agriculture,4933,178
Murray,Election Day,5715,Commissioner Of Agriculture,5535,180
Murray,Provisional,0,Commissioner Of Agriculture,0,0
Muscogee,Absentee by Mail,4422,Commissioner Of Agriculture,4352,70
Muscogee,Advance in Person,27700,Commissioner Of Agriculture,27045,655
Muscogee,Election Day,31019,Commissioner Of Agriculture,30112,907
Muscogee,Provisional,131,Commissioner Of Agriculture,126,5
Newton,Absentee by Mail,2735,Commissioner Of Agriculture,2676,59
Newton,Advance in Person,19236,Commissioner Of Agriculture,18801,435
Newton,Election Day,21158,Commissioner Of Agriculture,20687,471
Newton,Provisional,12,Commissioner Of Agriculture,12,0
Oconee,Absentee by Mail,931,Commissioner Of Agriculture,912,19
Oconee,Advance in Person,11688,Commissioner Of Agriculture,11499,189
Oconee,Election Day,8114,Commissioner Of Agriculture,7925,189
Oconee,Provisional,11,Commissioner Of Agriculture,11,0
Oglethorpe,Absentee by Mail,409,Commissioner Of Agriculture,405,4
Oglethorpe,Advance in Person,3417,Commissioner Of Agriculture,3344,73
Oglethorpe,Election Day,2658,Commissioner Of Agriculture,2570,88
Oglethorpe,Provisional,1,Commissioner Of Agriculture,1,0
Paulding,Absentee by Mail,3307,Commissioner Of Agriculture,3245,62
Paulding,Advance in Person,32842,Commissioner Of Agriculture,32260,582
Paulding,Election Day,25073,Commissioner Of Agriculture,24493,580
Paulding,Provisional,83,Commissioner Of Agriculture,81,2
Peach,Absentee by Mail,445,Commissioner Of Agriculture,438,7
Peach,Advance in Person,6720,Commissioner Of Agriculture,6560,160
Peach,Election Day,3190,Commissioner Of Agriculture,3093,97
Peach,Provisional,90,Commissioner Of Agriculture,86,4
Pickens,Absentee by Mail,222,Commissioner Of Agriculture,218,4
Pickens,Advance in Person,7121,Commissioner Of Agriculture,6950,171
Pickens,Election Day,6019,Commissioner Of Agriculture,5876,143
Pickens,Provisional,0,Commissioner Of Agriculture,0,0
Pierce,Absentee by Mail,327,Commissioner Of Agriculture,326,1
Pierce,Advance in Person,4598,Commissioner Of Agriculture,4506,92
Pierce,Election Day,1958,Commissioner Of Agriculture,1915,43
Pierce,Provisional,1,Commissioner Of Agriculture,1,0
Pike,Absentee by Mail,304,Commissioner Of Agriculture,299,5
Pike,Advance in Person,4478,Commissioner Of Agriculture,4410,68
Pike,Election Day,3752,Commissioner Of Agriculture,3647,105
Pike,Provisional,9,Commissioner Of Agriculture,9,0
Polk,Absentee by Mail,447,Commissioner Of Agriculture,443,4
Polk,Advance in Person,7744,Commissioner Of Agriculture,7561,183
Polk,Election Day,4668,Commissioner Of Agriculture,4505,163
Polk,Provisional,2,Commissioner Of Agriculture,2,0
Pulaski,Absentee by Mail,232,Commissioner Of Agriculture,227,5
Pulaski,Advance in Person,2522,Commissioner Of Agriculture,2438,84
Pulaski,Election Day,868,Commissioner Of Agriculture,818,50
Pulaski,Provisional,0,Commissioner Of Agriculture,0,0
Putnam,Absentee by Mail,598,Commissioner Of Agriculture,596,2
Putnam,Advance in Person,4858,Commissioner Of Agriculture,4757,101
Putnam,Election Day,3865,Commissioner Of Agriculture,3755,110
Putnam,Provisional,14,Commissioner Of Agriculture,14,0
Quitman,Absentee by Mail,60,Commissioner Of Agriculture,51,9
Quitman,Advance in Person,451,Commissioner Of Agriculture,426,25
Quitman,Election Day,429,Commissioner Of Agriculture,406,23
Quitman,Provisional,0,Commissioner Of Agriculture,0,0
Rabun,Absentee by Mail,843,Commissioner Of Agriculture,825,18
Rabun,Advance in Person,4889,Commissioner Of Agriculture,4798,91
Rabun,Election Day,1846,Commissioner Of Agriculture,1803,43
Rabun,Provisional,0,Commissioner Of Agriculture,0,0
Randolph,Absentee by Mail,313,Commissioner Of Agriculture,299,14
Randolph,Advance in Person,1232,Commissioner Of Agriculture,1181,51
Randolph,Election Day,1243,Commissioner Of Agriculture,1194,49
Randolph,Provisional,1,Commissioner Of Agriculture,1,0
Richmond,Absentee by Mail,5314,Commissioner Of Agriculture,5224,90
Richmond,Advance in Person,28737,Commissioner Of Agriculture,28052,685
Richmond,Election Day,35992,Commissioner Of Agriculture,34900,1092
Richmond,Provisional,112,Commissioner Of Agriculture,110,2
Rockdale,Absentee by Mail,1853,Commissioner Of Agriculture,1816,37
Rockdale,Advance in Person,22789,Commissioner Of Agriculture,22375,414
Rockdale,Election Day,11958,Commissioner Of Agriculture,11669,289
Rockdale,Provisional,55,Commissioner Of Agriculture,53,2
Schley,Absentee by Mail,96,Commissioner Of Agriculture,95,1
Schley,Advance in Person,1321,Commissioner Of Agriculture,1280,41
Schley,Election Day,514,Commissioner Of Agriculture,492,22
Schley,Provisional,2,Commissioner Of Agriculture,2,0
Screven,Absentee by Mail,271,Commissioner Of Agriculture,265,6
Screven,Advance in Person,2674,Commissioner Of Agriculture,2593,81
Screven,Election Day,2462,Commissioner Of Agriculture,2377,85
Screven,Provisional,7,Commissioner Of Agriculture,7,0
Seminole,Absentee by Mail,264,Commissioner Of Agriculture,262,2
Seminole,Advance in Person,1078,Commissioner Of Agriculture,1063,15
Seminole,Election Day,1872,Commissioner Of Agriculture,1810,62
Seminole,Provisional,13,Commissioner Of Agriculture,12,1
Spalding,Absentee by Mail,1283,Commissioner Of Agriculture,1241,42
Spalding,Advance in Person,13046,Commissioner Of Agriculture,12604,442
Spalding,Election Day,10056,Commissioner Of Agriculture,9757,299
Spalding,Provisional,32,Commissioner Of Agriculture,29,3
Stephens,Absentee by Mail,536,Commissioner Of Agriculture,528,8
Stephens,Advance in Person,6139,Commissioner Of Agriculture,6006,133
Stephens,Election Day,2394,Commissioner Of Agriculture,2322,72
Stephens,Provisional,18,Commissioner Of Agriculture,17,1
Stewart,Absentee by Mail,233,Commissioner Of Agriculture,217,16
Stewart,Advance in Person,694,Commissioner Of Agriculture,652,42
Stewart,Election Day,857,Commissioner Of Agriculture,771,86
Stewart,Provisional,35,Commissioner Of Agriculture,35,0
Sumter,Absentee by Mail,877,Commissioner Of Agriculture,851,26
Sumter,Advance in Person,5531,Commissioner Of Agriculture,5371,160
Sumter,Election Day,4148,Commissioner Of Agriculture,4025,123
Sumter,Provisional,0,Commissioner Of Agriculture,0,0
Talbot,Absentee by Mail,285,Commissioner Of Agriculture,263,22
Talbot,Advance in Person,772,Commissioner Of Agriculture,734,38
Talbot,Election Day,1895,Commissioner Of Agriculture,1782,113
Talbot,Provisional,2,Commissioner Of Agriculture,2,0
Taliaferro,Absentee by Mail,162,Commissioner Of Agriculture,149,13
Taliaferro,Advance in Person,441,Commissioner Of Agriculture,409,32
Taliaferro,Election Day,314,Commissioner Of Agriculture,286,28
Taliaferro,Provisional,4,Commissioner Of Agriculture,4,0
Tattnall,Absentee by Mail,392,Commissioner Of Agriculture,386,6
Tattnall,Advance in Person,3539,Commissioner Of Agriculture,3411,128
Tattnall,Election Day,2708,Commissioner Of Agriculture,2612,96
Tattnall,Provisional,8,Commissioner Of Agriculture,8,0
Taylor,Absentee by Mail,243,Commissioner Of Agriculture,240,3
Taylor,Advance in Person,1843,Commissioner Of Agriculture,1799,44
Taylor,Election Day,1179,Commissioner Of Agriculture,1132,47
Taylor,Provisional,29,Commissioner Of Agriculture,29,0
Telfair,Absentee by Mail,331,Commissioner Of Agriculture,327,4
Telfair,Advance in Person,1676,Commissioner Of Agriculture,1615,61
Telfair,Election Day,1624,Commissioner Of Agriculture,1548,76
Telfair,Provisional,1,Commissioner Of Agriculture,1,0
Terrell,Absentee by Mail,327,Commissioner Of Agriculture,323,4
Terrell,Advance in Person,1612,Commissioner Of Agriculture,1558,54
Terrell,Election Day,1991,Commissioner Of Agriculture,1900,91
Terrell,Provisional,9,Commissioner Of Agriculture,9,0
Thomas,Absentee by Mail,991,Commissioner Of Agriculture,975,16
Thomas,Advance in Person,8376,Commissioner Of Agriculture,8166,210
Thomas,Election Day,7874,Commissioner Of Agriculture,7656,218
Thomas,Provisional,3,Commissioner Of Agriculture,3,0
Tift,Absentee by Mail,561,Commissioner Of Agriculture,548,13
Tift,Advance in Person,7646,Commissioner Of Agriculture,7432,214
Tift,Election Day,5462,Commissioner Of Agriculture,5292,170
Tift,Provisional,4,Commissioner Of Agriculture,3,1
Toombs,Absentee by Mail,681,Commissioner Of Agriculture,665,16
Toombs,Advance in Person,4860,Commissioner Of Agriculture,4708,152
Toombs,Election Day,3310,Commissioner Of Agriculture,3210,100
Toombs,Provisional,9,Commissioner Of Agriculture,9,0
Towns,Absentee by Mail,284,Commissioner Of Agriculture,279,5
Towns,Advance in Person,4009,Commissioner Of Agriculture,3882,127
Towns,Election Day,1839,Commissioner Of Agriculture,1784,55
Towns,Provisional,0,Commissioner Of Agriculture,0,0
Treutlen,Absentee by Mail,146,Commissioner Of Agriculture,138,8
Treutlen,Advance in Person,1659,Commissioner Of Agriculture,1598,61
Treutlen,Election Day,805,Commissioner Of Agriculture,770,35
Treutlen,Provisional,4,Commissioner Of Agriculture,4,0
Troup,Absentee by Mail,1264,Commissioner Of Agriculture,1237,27
Troup,Advance in Person,11226,Commissioner Of Agriculture,10972,254
Troup,Election Day,11173,Commissioner Of Agriculture,10840,333
Troup,Provisional,250,Commissioner Of Agriculture,243,7
Turner,Absentee by Mail,148,Commissioner Of Agriculture,147,1
Turner,Advance in Person,1922,Commissioner Of Agriculture,1861,61
Turner,Election Day,1199,Commissioner Of Agriculture,1154,45
Turner,Provisional,5,Commissioner Of Agriculture,5,0
Twiggs,Absentee by Mail,275,Commissioner Of Agriculture,271,4
Twiggs,Advance in Person,1531,Commissioner Of Agriculture,1472,59
Twiggs,Election Day,1981,Commissioner Of Agriculture,1894,87
Twiggs,Provisional,5,Commissioner Of Agriculture,5,0
Union,Absentee by Mail,482,Commissioner Of Agriculture,477,5
Union,Advance in Person,6626,Commissioner Of Agriculture,6495,131
Union,Election Day,4755,Commissioner Of Agriculture,4603,152
Union,Provisional,2,Commissioner Of Agriculture,2,0
Upson,Absentee by Mail,602,Commissioner Of Agriculture,588,14
Upson,Advance in Person,6729,Commissioner Of Agriculture,6533,196
Upson,Election Day,3227,Commissioner Of Agriculture,3117,110
Upson,Provisional,10,Commissioner Of Agriculture,10,0
Walker,Absentee by Mail,813,Commissioner Of Agriculture,795,18
Walker,Advance in Person,11133,Commissioner Of Agriculture,10875,258
Walker,Election Day,9505,Commissioner Of Agriculture,9274,231
Walker,Provisional,39,Commissioner Of Agriculture,38,1
Walton,Absentee by Mail,1769,Commissioner Of Agriculture,1731,38
Walton,Advance in Person,14370,Commissioner Of Agriculture,14043,327
Walton,Election Day,22496,Commissioner Of Agriculture,21978,518
Walton,Provisional,51,Commissioner Of Agriculture,49,2
Ware,Absentee by Mail,627,Commissioner Of Agriculture,613,14
Ware,Advance in Person,5460,Commissioner Of Agriculture,5344,116
Ware,Election Day,4917,Commissioner Of Agriculture,4769,148
Ware,Provisional,12,Commissioner Of Agriculture,12,0
Warren,Absentee by Mail,187,Commissioner Of Agriculture,184,3
Warren,Advance in Person,1267,Commissioner Of Agriculture,1215,52
Warren,Election Day,806,Commissioner Of Agriculture,769,37
Warren,Provisional,1,Commissioner Of Agriculture,1,0
Washington,Absentee by Mail,727,Commissioner Of Agriculture,705,22
Washington,Advance in Person,3907,Commissioner Of Agriculture,3733,174
Washington,Election Day,3525,Commissioner Of Agriculture,3341,184
Washington,Provisional,10,Commissioner Of Agriculture,10,0
Wayne,Absentee by Mail,501,Commissioner Of Agriculture,498,3
Wayne,Advance in Person,5868,Commissioner Of Agriculture,5712,156
Wayne,Election Day,3753,Commissioner Of Agriculture,3650,103
Wayne,Provisional,10,Commissioner Of Agriculture,9,1
Webster,Absentee by Mail,152,Commissioner Of Agriculture,148,4
Webster,Advance in Person,544,Commissioner Of Agriculture,534,10
Webster,Election Day,404,Commissioner Of Agriculture,386,18
Webster,Provisional,0,Commissioner Of Agriculture,0,0
Wheeler,Absentee by Mail,115,Commissioner Of Agriculture,115,0
Wheeler,Advance in Person,974,Commissioner Of Agriculture,940,34
Wheeler,Election Day,838,Commissioner Of Agriculture,799,39
Wheeler,Provisional,4,Commissioner Of Agriculture,4,0
White,Absentee by Mail,537,Commissioner Of Agriculture,534,3
White,Advance in Person,5408,Commissioner Of Agriculture,5290,118
White,Election Day,5489,Commissioner Of Agriculture,5400,89
White,Provisional,6,Commissioner Of Agriculture,6,0
Whitfield,Absentee by Mail,1017,Commissioner Of Agriculture,998,19
Whitfield,Advance in Person,9610,Commissioner Of Agriculture,9400,210
Whitfield,Election Day,16675,Commissioner Of Agriculture,16126,549
Whitfield,Provisional,25,Commissioner Of Agriculture,24,1
Wilcox,Absentee by Mail,205,Commissioner Of Agriculture,200,5
Wilcox,Advance in Person,1202,Commissioner Of Agriculture,1177,25
Wilcox,Election Day,1408,Commissioner Of Agriculture,1351,57
Wilcox,Provisional,0,Commissioner Of Agriculture,0,0
Wilkes,Absentee by Mail,301,Commissioner Of Agriculture,294,7
Wilkes,Advance in Person,2075,Commissioner Of Agriculture,1997,78
Wilkes,Election Day,1995,Commissioner Of Agriculture,1910,85
Wilkes,Provisional,6,Commissioner Of Agriculture,6,0
Wilkinson,Absentee by Mail,270,Commissioner Of Agriculture,261,9
Wilkinson,Advance in Person,1567,Commissioner Of Agriculture,1512,55
Wilkinson,Election Day,2427,Commissioner Of Agriculture,2307,120
Wilkinson,Provisional,1,Commissioner Of Agriculture,1,0
Worth,Absentee by Mail,305,Commissioner Of Agriculture,300,5
Worth,Advance in Person,3108,Commissioner Of Agriculture,3032,76
Worth,Election Day,4418,Commissioner Of Agriculture,4279,139
Worth,Provisional,15,Commissioner Of Agriculture,15,0
Appling,Absentee by Mail,530,Commissioner Of Insurance,517,13
Appling,Advance in Person,3298,Commissioner Of Insurance,3205,93
Appling,Election Day,2978,Commissioner Of Insurance,2882,96
Appling,Provisional,3,Commissioner Of Insurance,3,0
Atkinson,Absentee by Mail,88,Commissioner Of Insurance,88,0
Atkinson,Advance in Person,1285,Commissioner Of Insurance,1227,58
Atkinson,Election Day,1147,Commissioner Of Insurance,1089,58
Atkinson,Provisional,2,Commissioner Of Insurance,2,0
Bacon,Absentee by Mail,174,Commissioner Of Insurance,172,2
Bacon,Advance in Person,2828,Commissioner Of Insurance,2764,64
Bacon,Election Day,827,Commissioner Of Insurance,785,42
Bacon,Provisional,1,Commissioner Of Insurance,1,0
Baker,Absentee by Mail,141,Commissioner Of Insurance,134,7
Baker,Advance in Person,485,Commissioner Of Insurance,463,22
Baker,Election Day,665,Commissioner Of Insurance,632,33
Baker,Provisional,2,Commissioner Of Insurance,2,0
Baldwin,Absentee by Mail,1158,Commissioner Of Insurance,1141,17
Baldwin,Advance in Person,8295,Commissioner Of Insurance,8067,228
Baldwin,Election Day,6180,Commissioner Of Insurance,6006,174
Baldwin,Provisional,3,Commissioner Of Insurance,3,0
Banks,Absentee by Mail,223,Commissioner Of Insurance,220,3
Banks,Advance in Person,2771,Commissioner Of Insurance,2726,45
Banks,Election Day,3858,Commissioner Of Insurance,3788,70
Banks,Provisional,1,Commissioner Of Insurance,1,0
Barrow,Absentee by Mail,1263,Commissioner Of Insurance,1246,17
Barrow,Advance in Person,12223,Commissioner Of Insurance,12042,181
Barrow,Election Day,13912,Commissioner Of Insurance,13671,241
Barrow,Provisional,7,Commissioner Of Insurance,7,0
Bartow,Absentee by Mail,1568,Commissioner Of Insurance,1559,9
Bartow,Advance in Person,16175,Commissioner Of Insurance,15952,223
Bartow,Election Day,19584,Commissioner Of Insurance,19255,329
Bartow,Provisional,32,Commissioner Of Insurance,32,0
Ben Hill,Absentee by Mail,320,Commissioner Of Insurance,314,6
Ben Hill,Advance in Person,3605,Commissioner Of Insurance,3543,62
Ben Hill,Election Day,1608,Commissioner Of Insurance,1566,42
Ben Hill,Provisional,14,Commissioner Of Insurance,14,0
Berrien,Absentee by Mail,322,Commissioner Of Insurance,318,4
Berrien,Advance in Person,3153,Commissioner Of Insurance,3083,70
Berrien,Election Day,2772,Commissioner Of Insurance,2701,71
Berrien,Provisional,5,Commissioner Of Insurance,4,1
Bibb,Absentee by Mail,4461,Commissioner Of Insurance,4412,49
Bibb,Advance in Person,26183,Commissioner Of Insurance,25639,544
Bibb,Election Day,29816,Commissioner Of Insurance,29190,626
Bibb,Provisional,232,Commissioner Of Insurance,230,2
Bleckley,Absentee by Mail,257,Commissioner Of Insurance,252,5
Bleckley,Advance in Person,2805,Commissioner Of Insurance,2721,84
Bleckley,Election Day,1793,Commissioner Of Insurance,1735,58
Bleckley,Provisional,5,Commissioner Of Insurance,5,0
Brantley,Absentee by Mail,188,Commissioner Of Insurance,184,4
Brantley,Advance in Person,2868,Commissioner Of Insurance,2819,49
Brantley,Election Day,2633,Commissioner Of Insurance,2512,121
Brantley,Provisional,5,Commissioner Of Insurance,5,0
Brooks,Absentee by Mail,465,Commissioner Of Insurance,452,13
Brooks,Advance in Person,2417,Commissioner Of Insurance,2357,60
Brooks,Election Day,2814,Commissioner Of Insurance,2726,88
Brooks,Provisional,27,Commissioner Of Insurance,27,0
Bryan,Absentee by Mail,582,Commissioner Of Insurance,575,7
Bryan,Advance in Person,8342,Commissioner Of Insurance,8206,136
Bryan,Election Day,6046,Commissioner Of Insurance,5936,110
Bryan,Provisional,15,Commissioner Of Insurance,15,0
Bulloch,Absentee by Mail,1076,Commissioner Of Insurance,1059,17
Bulloch,Advance in Person,11170,Commissioner Of Insurance,10927,243
Bulloch,Election Day,11297,Commissioner Of Insurance,11022,275
Bulloch,Provisional,140,Commissioner Of Insurance,137,3
Burke,Absentee by Mail,968,Commissioner Of Insurance,957,11
Burke,Advance in Person,3199,Commissioner Of Insurance,3129,70
Burke,Election Day,4552,Commissioner Of Insurance,4427,125
Burke,Provisional,2,Commissioner Of Insurance,2,0
Butts,Absentee by Mail,380,Commissioner Of Insurance,374,6
Butts,Advance in Person,6277,Commissioner Of Insurance,6144,133
Butts,Election Day,2206,Commissioner Of Insurance,2166,40
Butts,Provisional,0,Commissioner Of Insurance,0,0
Calhoun,Absentee by Mail,185,Commissioner Of Insurance,180,5
Calhoun,Advance in Person,607,Commissioner Of Insurance,593,14
Calhoun,Election Day,1107,Commissioner Of Insurance,1079,28
Calhoun,Provisional,0,Commissioner Of Insurance,0,0
Camden,Absentee by Mail,1193,Commissioner Of Insurance,1179,14
Camden,Advance in Person,8085,Commissioner Of Insurance,7963,122
Camden,Election Day,7775,Commissioner Of Insurance,7609,166
Camden,Provisional,8,Commissioner Of Insurance,8,0
Candler,Absentee by Mail,120,Commissioner Of Insurance,116,4
Candler,Advance in Person,2335,Commissioner Of Insurance,2286,49
Candler,Election Day,1083,Commissioner Of Insurance,1049,34
Candler,Provisional,1,Commissioner Of Insurance,1,0
Carroll,Absentee by Mail,1518,Commissioner Of Insurance,1501,17
Carroll,Advance in Person,20100,Commissioner Of Insurance,19861,239
Carroll,Election Day,20121,Commissioner Of Insurance,19792,329
Carroll,Provisional,104,Commissioner Of Insurance,102,2
Catoosa,Absentee by Mail,540,Commissioner Of Insurance,533,7
Catoosa,Advance in Person,13673,Commissioner Of Insurance,13441,232
Catoosa,Election Day,9512,Commissioner Of Insurance,9336,176
Catoosa,Provisional,33,Commissioner Of Insurance,33,0
Charlton,Absentee by Mail,163,Commissioner Of Insurance,160,3
Charlton,Advance in Person,1549,Commissioner Of Insurance,1517,32
Charlton,Election Day,1657,Commissioner Of Insurance,1595,62
Charlton,Provisional,8,Commissioner Of Insurance,8,0
Chatham,Absentee by Mail,6177,Commissioner Of Insurance,6069,108
Chatham,Advance in Person,32338,Commissioner Of Insurance,31776,562
Chatham,Election Day,64823,Commissioner Of Insurance,63315,1508
Chatham,Provisional,205,Commissioner Of Insurance,202,3
Chattahoochee,Absentee by Mail,35,Commissioner Of Insurance,35,0
Chattahoochee,Advance in Person,493,Commissioner Of Insurance,470,23
Chattahoochee,Election Day,574,Commissioner Of Insurance,558,16
Chattahoochee,Provisional,3,Commissioner Of Insurance,3,0
Chattooga,Absentee by Mail,225,Commissioner Of Insurance,224,1
Chattooga,Advance in Person,3452,Commissioner Of Insurance,3364,88
Chattooga,Election Day,3750,Commissioner Of Insurance,3629,121
Chattooga,Provisional,7,Commissioner Of Insurance,7,0
Cherokee,Absentee by Mail,5312,Commissioner Of Insurance,5224,88
Cherokee,Advance in Person,48565,Commissioner Of Insurance,48004,561
Cherokee,Election Day,52422,Commissioner Of Insurance,51448,974
Cherokee,Provisional,112,Commissioner Of Insurance,111,1
Clarke,Absentee by Mail,3022,Commissioner Of Insurance,2968,54
Clarke,Advance in Person,19957,Commissioner Of Insurance,19570,387
Clarke,Election Day,20282,Commissioner Of Insurance,19670,612
Clarke,Provisional,41,Commissioner Of Insurance,40,1
Clay,Absentee by Mail,143,Commissioner Of Insurance,138,5
Clay,Advance in Person,579,Commissioner Of Insurance,560,19
Clay,Election Day,464,Commissioner Of Insurance,448,16
Clay,Provisional,0,Commissioner Of Insurance,0,0
Clayton,Absentee by Mail,5847,Commissioner Of Insurance,5766,81
Clayton,Advance in Person,47671,Commissioner Of Insurance,46941,730
Clayton,Election Day,38322,Commissioner Of Insurance,37559,763
Clayton,Provisional,372,Commissioner Of Insurance,360,12
Clinch,Absentee by Mail,109,Commissioner Of Insurance,109,0
Clinch,Advance in Person,1236,Commissioner Of Insurance,1184,52
Clinch,Election Day,909,Commissioner Of Insurance,874,35
Clinch,Provisional,4,Commissioner Of Insurance,4,0
Cobb,Absentee by Mail,25901,Commissioner Of Insurance,25423,478
Cobb,Advance in Person,111554,Commissioner Of Insurance,110244,1310
Cobb,Election Day,172926,Commissioner Of Insurance,169810,3116
Cobb,Provisional,1433,Commissioner Of Insurance,1398,35
Coffee,Absentee by Mail,395,Commissioner Of Insurance,388,7
Coffee,Advance in Person,7664,Commissioner Of Insurance,7420,244
Coffee,Election Day,4536,Commissioner Of Insurance,4392,144
Coffee,Provisional,20,Commissioner Of Insurance,19,1
Colquitt,Absentee by Mail,514,Commissioner Of Insurance,510,4
Colquitt,Advance in Person,6071,Commissioner Of Insurance,5892,179
Colquitt,Election Day,6368,Commissioner Of Insurance,6115,253
Colquitt,Provisional,10,Commissioner Of Insurance,10,0
Columbia,Absentee by Mail,2936,Commissioner Of Insurance,2899,37
Columbia,Advance in Person,29686,Commissioner Of Insurance,29364,322
Columbia,Election Day,28969,Commissioner Of Insurance,28468,501
Columbia,Provisional,43,Commissioner Of Insurance,43,0
Cook,Absentee by Mail,244,Commissioner Of Insurance,242,2
Cook,Advance in Person,3069,Commissioner Of Insurance,3008,61
Cook,Election Day,2490,Commissioner Of Insurance,2439,51
Cook,Provisional,0,Commissioner Of Insurance,0,0
Coweta,Absentee by Mail,2812,Commissioner Of Insurance,2790,22
Coweta,Advance in Person,25641,Commissioner Of Insurance,25320,321
Coweta,Election Day,29603,Commissioner Of Insurance,29085,518
Coweta,Provisional,15,Commissioner Of Insurance,15,0
Crawford,Absentee by Mail,234,Commissioner Of Insurance,230,4
Crawford,Advance in Person,2567,Commissioner Of Insurance,2492,75
Crawford,Election Day,2130,Commissioner Of Insurance,2086,44
Crawford,Provisional,3,Commissioner Of Insurance,3,0
Crisp,Absentee by Mail,363,Commissioner Of Insurance,351,12
Crisp,Advance in Person,4191,Commissioner Of Insurance,4083,108
Crisp,Election Day,2470,Commissioner Of Insurance,2348,122
Crisp,Provisional,26,Commissioner Of Insurance,23,3
Dade,Absentee by Mail,129,Commissioner Of Insurance,122,7
Dade,Advance in Person,2561,Commissioner Of Insurance,2472,89
Dade,Election Day,2760,Commissioner Of Insurance,2676,84
Dade,Provisional,12,Commissioner Of Insurance,12,0
Dawson,Absentee by Mail,439,Commissioner Of Insurance,436,3
Dawson,Advance in Person,7020,Commissioner Of Insurance,6934,86
Dawson,Election Day,4111,Commissioner Of Insurance,4035,76
Dawson,Provisional,11,Commissioner Of Insurance,11,0
DeKalb,Absentee by Mail,19672,Commissioner Of Insurance,19262,410
DeKalb,Advance in Person,150814,Commissioner Of Insurance,148087,2727
DeKalb,Election Day,140482,Commissioner Of Insurance,136779,3703
DeKalb,Provisional,1773,Commissioner Of Insurance,1715,58
Decatur,Absentee by Mail,548,Commissioner Of Insurance,543,5
Decatur,Advance in Person,4260,Commissioner Of Insurance,4160,100
Decatur,Election Day,4235,Commissioner Of Insurance,4130,105
Decatur,Provisional,103,Commissioner Of Insurance,98,5
Dodge,Absentee by Mail,448,Commissioner Of Insurance,435,13
Dodge,Advance in Person,3411,Commissioner Of Insurance,3279,132
Dodge,Election Day,3192,Commissioner Of Insurance,3033,159
Dodge,Provisional,10,Commissioner Of Insurance,10,0
Dooly,Absentee by Mail,196,Commissioner Of Insurance,190,6
Dooly,Advance in Person,1889,Commissioner Of Insurance,1817,72
Dooly,Election Day,1708,Commissioner Of Insurance,1643,65
Dooly,Provisional,2,Commissioner Of Insurance,1,1
Dougherty,Absentee by Mail,1944,Commissioner Of Insurance,1917,27
Dougherty,Advance in Person,11332,Commissioner Of Insurance,11106,226
Dougherty,Election Day,18021,Commissioner Of Insurance,17563,458
Dougherty,Provisional,128,Commissioner Of Insurance,124,4
Douglas,Absentee by Mail,3233,Commissioner Of Insurance,3205,28
Douglas,Advance in Person,30219,Commissioner Of Insurance,29887,332
Douglas,Election Day,21745,Commissioner Of Insurance,21457,288
Douglas,Provisional,58,Commissioner Of Insurance,58,0
Early,Absentee by Mail,473,Commissioner Of Insurance,469,4
Early,Advance in Person,1569,Commissioner Of Insurance,1541,28
Early,Election Day,2089,Commissioner Of Insurance,2038,51
Early,Provisional,4,Commissioner Of Insurance,4,0
Echols,Absentee by Mail,35,Commissioner Of Insurance,35,0
Echols,Advance in Person,767,Commissioner Of Insurance,745,22
Echols,Election Day,341,Commissioner Of Insurance,328,13
Echols,Provisional,0,Commissioner Of Insurance,0,0
Effingham,Absentee by Mail,750,Commissioner Of Insurance,736,14
Effingham,Advance in Person,10717,Commissioner Of Insurance,10556,161
Effingham,Election Day,11898,Commissioner Of Insurance,11713,185
Effingham,Provisional,6,Commissioner Of Insurance,6,0
Elbert,Absentee by Mail,563,Commissioner Of Insurance,561,2
Elbert,Advance in Person,3722,Commissioner Of Insurance,3639,83
Elbert,Election Day,3034,Commissioner Of Insurance,2936,98
Elbert,Provisional,69,Commissioner Of Insurance,67,2
Emanuel,Absentee by Mail,390,Commissioner Of Insurance,382,8
Emanuel,Advance in Person,3424,Commissioner Of Insurance,3327,97
Emanuel,Election Day,3896,Commissioner Of Insurance,3734,162
Emanuel,Provisional,6,Commissioner Of Insurance,6,0
Evans,Absentee by Mail,199,Commissioner Of Insurance,197,2
Evans,Advance in Person,2162,Commissioner Of Insurance,2080,82
Evans,Election Day,1086,Commissioner Of Insurance,1047,39
Evans,Provisional,0,Commissioner Of Insurance,0,0
Fannin,Absentee by Mail,658,Commissioner Of Insurance,646,12
Fannin,Advance in Person,5341,Commissioner Of Insurance,5245,96
Fannin,Election Day,5204,Commissioner Of Insurance,5076,128
Fannin,Provisional,16,Commissioner Of Insurance,15,1
Fayette,Absentee by Mail,2647,Commissioner Of Insurance,2603,44
Fayette,Advance in Person,31073,Commissioner Of Insurance,30685,388
Fayette,Election Day,24242,Commissioner Of Insurance,23762,480
Fayette,Provisional,36,Commissioner Of Insurance,35,1
Floyd,Absentee by Mail,1260,Commissioner Of Insurance,1244,16
Floyd,Advance in Person,13688,Commissioner Of Insurance,13450,238
Floyd,Election Day,15277,Commissioner Of Insurance,14890,387
Floyd,Provisional,113,Commissioner Of Insurance,111,2
Forsyth,Absentee by Mail,4428,Commissioner Of Insurance,4334,94
Forsyth,Advance in Person,52559,Commissioner Of Insurance,51944,615
Forsyth,Election Day,36252,Commissioner Of Insurance,35573,679
Forsyth,Provisional,59,Commissioner Of Insurance,59,0
Franklin,Absentee by Mail,388,Commissioner Of Insurance,383,5
Franklin,Advance in Person,3502,Commissioner Of Insurance,3458,44
Franklin,Election Day,4259,Commissioner Of Insurance,4176,83
Franklin,Provisional,0,Commissioner Of Insurance,0,0
Fulton,Absentee by Mail,17842,Commissioner Of Insurance,17365,477
Fulton,Advance in Person,224522,Commissioner Of Insurance,220223,4299
Fulton,Election Day,179442,Commissioner Of Insurance,174415,5027
Fulton,Provisional,1982,Commissioner Of Insurance,1900,82
Gilmer,Absentee by Mail,559,Commissioner Of Insurance,553,6
Gilmer,Advance in Person,6295,Commissioner Of Insurance,6177,118
Gilmer,Election Day,5617,Commissioner Of Insurance,5501,116
Gilmer,Provisional,39,Commissioner Of Insurance,36,3
Glascock,Absentee by Mail,81,Commissioner Of Insurance,80,1
Glascock,Advance in Person,652,Commissioner Of Insurance,625,27
Glascock,Election Day,567,Commissioner Of Insurance,534,33
Glascock,Provisional,1,Commissioner Of Insurance,1,0
Glynn,Absentee by Mail,1812,Commissioner Of Insurance,1795,17
Glynn,Advance in Person,17510,Commissioner Of Insurance,17199,311
Glynn,Election Day,13179,Commissioner Of Insurance,12867,312
Glynn,Provisional,147,Commissioner Of Insurance,138,9
Gordon,Absentee by Mail,547,Commissioner Of Insurance,533,14
Gordon,Advance in Person,8119,Commissioner Of Insurance,7933,186
Gordon,Election Day,9106,Commissioner Of Insurance,8909,197
Gordon,Provisional,32,Commissioner Of Insurance,31,1
Grady,Absentee by Mail,400,Commissioner Of Insurance,394,6
Grady,Advance in Person,3857,Commissioner Of Insurance,3791,66
Grady,Election Day,4099,Commissioner Of Insurance,4003,96
Grady,Provisional,14,Commissioner Of Insurance,14,0
Greene,Absentee by Mail,623,Commissioner Of Insurance,614,9
Greene,Advance in Person,5593,Commissioner Of Insurance,5520,73
Greene,Election Day,2773,Commissioner Of Insurance,2714,59
Greene,Provisional,6,Commissioner Of Insurance,6,0
Gwinnett,Absentee by Mail,20397,Commissioner Of Insurance,20133,264
Gwinnett,Advance in Person,137166,Commissioner Of Insurance,135428,1738
Gwinnett,Election Day,155146,Commissioner Of Insurance,152336,2810
Gwinnett,Provisional,2209,Commissioner Of Insurance,2165,44
Habersham,Absentee by Mail,853,Commissioner Of Insurance,842,11
Habersham,Advance in Person,10023,Commissioner Of Insurance,9834,189
Habersham,Election Day,4619,Commissioner Of Insurance,4508,111
Habersham,Provisional,5,Commissioner Of Insurance,5,0
Hall,Absentee by Mail,3493,Commissioner Of Insurance,3453,40
Hall,Advance in Person,24348,Commissioner Of Insurance,23994,354
Hall,Election Day,39441,Commissioner Of Insurance,38659,782
Hall,Provisional,124,Commissioner Of Insurance,119,5
Hancock,Absentee by Mail,490,Commissioner Of Insurance,477,13
Hancock,Advance in Person,1531,Commissioner Of Insurance,1466,65
Hancock,Election Day,1518,Commissioner Of Insurance,1441,77
Hancock,Provisional,9,Commissioner Of Insurance,8,1
Haralson,Absentee by Mail,393,Commissioner Of Insurance,391,2
Haralson,Advance in Person,4202,Commissioner Of Insurance,4140,62
Haralson,Election Day,5990,Commissioner Of Insurance,5900,90
Haralson,Provisional,0,Commissioner Of Insurance,0,0
Harris,Absentee by Mail,729,Commissioner Of Insurance,718,11
Harris,Advance in Person,7251,Commissioner Of Insurance,7146,105
Harris,Election Day,7992,Commissioner Of Insurance,7801,191
Harris,Provisional,14,Commissioner Of Insurance,14,0
Hart,Absentee by Mail,440,Commissioner Of Insurance,434,6
Hart,Advance in Person,5220,Commissioner Of Insurance,5065,155
Hart,Election Day,3958,Commissioner Of Insurance,3829,129
Hart,Provisional,4,Commissioner Of Insurance,4,0
Heard,Absentee by Mail,278,Commissioner Of Insurance,275,3
Heard,Advance in Person,1427,Commissioner Of Insurance,1400,27
Heard,Election Day,2346,Commissioner Of Insurance,2292,54
Heard,Provisional,4,Commissioner Of Insurance,4,0
Henry,Absentee by Mail,4997,Commissioner Of Insurance,4930,67
Henry,Advance in Person,58658,Commissioner Of Insurance,57887,771
Henry,Election Day,34710,Commissioner Of Insurance,34161,549
Henry,Provisional,193,Commissioner Of Insurance,187,6
Houston,Absentee by Mail,3190,Commissioner Of Insurance,3136,54
Houston,Advance in Person,34816,Commissioner Of Insurance,34371,445
Houston,Election Day,21152,Commissioner Of Insurance,20771,381
Houston,Provisional,74,Commissioner Of Insurance,72,2
Irwin,Absentee by Mail,133,Commissioner Of Insurance,132,1
Irwin,Advance in Person,2048,Commissioner Of Insurance,1999,49
Irwin,Election Day,1375,Commissioner Of Insurance,1346,29
Irwin,Provisional,8,Commissioner Of Insurance,8,0
Jackson,Absentee by Mail,1019,Commissioner Of Insurance,1008,11
Jackson,Advance in Person,14919,Commissioner Of Insurance,14718,201
Jackson,Election Day,10951,Commissioner Of Insurance,10771,180
Jackson,Provisional,10,Commissioner Of Insurance,10,0
Jasper,Absentee by Mail,421,Commissioner Of Insurance,418,3
Jasper,Advance in Person,2981,Commissioner Of Insurance,2927,54
Jasper,Election Day,2505,Commissioner Of Insurance,2450,55
Jasper,Provisional,38,Commissioner Of Insurance,37,1
Jeff Davis,Absentee by Mail,229,Commissioner Of Insurance,223,6
Jeff Davis,Advance in Person,2680,Commissioner Of Insurance,2597,83
Jeff Davis,Election Day,1906,Commissioner Of Insurance,1830,76
Jeff Davis,Provisional,0,Commissioner Of Insurance,0,0
Jefferson,Absentee by Mail,607,Commissioner Of Insurance,592,15
Jefferson,Advance in Person,2803,Commissioner Of Insurance,2681,122
Jefferson,Election Day,3346,Commissioner Of Insurance,3203,143
Jefferson,Provisional,11,Commissioner Of Insurance,11,0
Jenkins,Absentee by Mail,188,Commissioner Of Insurance,184,4
Jenkins,Advance in Person,1557,Commissioner Of Insurance,1511,46
Jenkins,Election Day,1111,Commissioner Of Insurance,1081,30
Jenkins,Provisional,16,Commissioner Of Insurance,16,0
Johnson,Absentee by Mail,236,Commissioner Of Insurance,231,5
Johnson,Advance in Person,1970,Commissioner Of Insurance,1892,78
Johnson,Election Day,1277,Commissioner Of Insurance,1225,52
Johnson,Provisional,0,Commissioner Of Insurance,0,0
Jones,Absentee by Mail,784,Commissioner Of Insurance,767,17
Jones,Advance in Person,6968,Commissioner Of Insurance,6829,139
Jones,Election Day,4680,Commissioner Of Insurance,4586,94
Jones,Provisional,9,Commissioner Of Insurance,9,0
Lamar,Absentee by Mail,404,Commissioner Of Insurance,401,3
Lamar,Advance in Person,3820,Commissioner Of Insurance,3737,83
Lamar,Election Day,3122,Commissioner Of Insurance,3060,62
Lamar,Provisional,11,Commissioner Of Insurance,11,0
Lanier,Absentee by Mail,108,Commissioner Of Insurance,105,3
Lanier,Advance in Person,1661,Commissioner Of Insurance,1606,55
Lanier,Election Day,910,Commissioner Of Insurance,863,47
Lanier,Provisional,2,Commissioner Of Insurance,2,0
Laurens,Absentee by Mail,1286,Commissioner Of Insurance,1256,30
Laurens,Advance in Person,8485,Commissioner Of Insurance,8245,240
Laurens,Election Day,9168,Commissioner Of Insurance,8896,272
Laurens,Provisional,13,Commissioner Of Insurance,13,0
Lee,Absentee by Mail,480,Commissioner Of Insurance,474,6
Lee,Advance in Person,5681,Commissioner Of Insurance,5602,79
Lee,Election Day,7388,Commissioner Of Insurance,7258,130
Lee,Provisional,6,Commissioner Of Insurance,6,0
Liberty,Absentee by Mail,950,Commissioner Of Insurance,941,9
Liberty,Advance in Person,8143,Commissioner Of Insurance,8019,124
Liberty,Election Day,6265,Commissioner Of Insurance,6156,109
Liberty,Provisional,10,Commissioner Of Insurance,9,1
Lincoln,Absentee by Mail,350,Commissioner Of Insurance,349,1
Lincoln,Advance in Person,1937,Commissioner Of Insurance,1895,42
Lincoln,Election Day,1680,Commissioner Of Insurance,1631,49
Lincoln,Provisional,2,Commissioner Of Insurance,2,0
Long,Absentee by Mail,169,Commissioner Of Insurance,168,1
Long,Advance in Person,1971,Commissioner Of Insurance,1916,55
Long,Election Day,1848,Commissioner Of Insurance,1795,53
Long,Provisional,10,Commissioner Of Insurance,10,0
Lowndes,Absentee by Mail,1890,Commissioner Of Insurance,1855,35
Lowndes,Advance in Person,21238,Commissioner Of Insurance,20943,295
Lowndes,Election Day,12084,Commissioner Of Insurance,11828,256
Lowndes,Provisional,541,Commissioner Of Insurance,521,20
Lumpkin,Absentee by Mail,467,Commissioner Of Insurance,461,6
Lumpkin,Advance in Person,7377,Commissioner Of Insurance,7266,111
Lumpkin,Election Day,3707,Commissioner Of Insurance,3629,78
Lumpkin,Provisional,7,Commissioner Of Insurance,7,0
Macon,Absentee by Mail,331,Commissioner Of Insurance,317,14
Macon,Advance in Person,2251,Commissioner Of Insurance,2132,119
Macon,Election Day,1635,Commissioner Of Insurance,1565,70
Macon,Provisional,0,Commissioner Of Insurance,0,0
Madison,Absentee by Mail,527,Commissioner Of Insurance,520,7
Madison,Advance in Person,5242,Commissioner Of Insurance,5128,114
Madison,Election Day,5928,Commissioner Of Insurance,5796,132
Madison,Provisional,2,Commissioner Of Insurance,2,0
Marion,Absentee by Mail,241,Commissioner Of Insurance,238,3
Marion,Advance in Person,1222,Commissioner Of Insurance,1182,40
Marion,Election Day,1467,Commissioner Of Insurance,1423,44
Marion,Provisional,1,Commissioner Of Insurance,1,0
McDuffie,Absentee by Mail,868,Commissioner Of Insurance,860,8
McDuffie,Advance in Person,5045,Commissioner Of Insurance,4949,96
McDuffie,Election Day,2879,Commissioner Of Insurance,2812,67
McDuffie,Provisional,0,Commissioner Of Insurance,0,0
McIntosh,Absentee by Mail,440,Commissioner Of Insurance,435,5
McIntosh,Advance in Person,2945,Commissioner Of Insurance,2874,71
McIntosh,Election Day,2023,Commissioner Of Insurance,1961,62
McIntosh,Provisional,0,Commissioner Of Insurance,0,0
Meriwether,Absentee by Mail,483,Commissioner Of Insurance,480,3
Meriwether,Advance in Person,2831,Commissioner Of Insurance,2777,54
Meriwether,Election Day,5325,Commissioner Of Insurance,5179,146
Meriwether,Provisional,11,Commissioner Of Insurance,10,1
Miller,Absentee by Mail,132,Commissioner Of Insurance,126,6
Miller,Advance in Person,1029,Commissioner Of Insurance,984,45
Miller,Election Day,1152,Commissioner Of Insurance,1102,50
Miller,Provisional,2,Commissioner Of Insurance,2,0
Mitchell,Absentee by Mail,564,Commissioner Of Insurance,559,5
Mitchell,Advance in Person,3343,Commissioner Of Insurance,3265,78
Mitchell,Election Day,3539,Commissioner Of Insurance,3447,92
Mitchell,Provisional,9,Commissioner Of Insurance,9,0
Monroe,Absentee by Mail,696,Commissioner Of Insurance,695,1
Monroe,Advance in Person,6311,Commissioner Of Insurance,6172,139
Monroe,Election Day,5925,Commissioner Of Insurance,5797,128
Monroe,Provisional,10,Commissioner Of Insurance,10,0
Montgomery,Absentee by Mail,211,Commissioner Of Insurance,206,5
Montgomery,Advance in Person,1416,Commissioner Of Insurance,1373,43
Montgomery,Election Day,1901,Commissioner Of Insurance,1845,56
Montgomery,Provisional,0,Commissioner Of Insurance,0,0
Morgan,Absentee by Mail,410,Commissioner Of Insurance,401,9
Morgan,Advance in Person,5406,Commissioner Of Insurance,5310,96
Morgan,Election Day,3738,Commissioner Of Insurance,3657,81
Morgan,Provisional,4,Commissioner Of Insurance,4,0
Murray,Absentee by Mail,265,Commissioner Of Insurance,258,7
Murray,Advance in Person,5111,Commissioner Of Insurance,4976,135
Murray,Election Day,5715,Commissioner Of Insurance,5540,175
Murray,Provisional,0,Commissioner Of Insurance,0,0
Muscogee,Absentee by Mail,4422,Commissioner Of Insurance,4366,56
Muscogee,Advance in Person,27700,Commissioner Of Insurance,27150,550
Muscogee,Election Day,31019,Commissioner Of Insurance,30284,735
Muscogee,Provisional,131,Commissioner Of Insurance,125,6
Newton,Absentee by Mail,2735,Commissioner Of Insurance,2703,32
Newton,Advance in Person,19236,Commissioner Of Insurance,18896,340
Newton,Election Day,21158,Commissioner Of Insurance,20774,384
Newton,Provisional,12,Commissioner Of Insurance,11,1
Oconee,Absentee by Mail,931,Commissioner Of Insurance,916,15
Oconee,Advance in Person,11688,Commissioner Of Insurance,11491,197
Oconee,Election Day,8114,Commissioner Of Insurance,7915,199
Oconee,Provisional,11,Commissioner Of Insurance,11,0
Oglethorpe,Absentee by Mail,409,Commissioner Of Insurance,404,5
Oglethorpe,Advance in Person,3417,Commissioner Of Insurance,3347,70
Oglethorpe,Election Day,2658,Commissioner Of Insurance,2573,85
Oglethorpe,Provisional,1,Commissioner Of Insurance,1,0
Paulding,Absentee by Mail,3307,Commissioner Of Insurance,3259,48
Paulding,Advance in Person,32842,Commissioner Of Insurance,32415,427
Paulding,Election Day,25073,Commissioner Of Insurance,24688,385
Paulding,Provisional,83,Commissioner Of Insurance,82,1
Peach,Absentee by Mail,445,Commissioner Of Insurance,438,7
Peach,Advance in Person,6720,Commissioner Of Insurance,6578,142
Peach,Election Day,3190,Commissioner Of Insurance,3115,75
Peach,Provisional,90,Commissioner Of Insurance,87,3
Pickens,Absentee by Mail,222,Commissioner Of Insurance,220,2
Pickens,Advance in Person,7121,Commissioner Of Insurance,6985,136
Pickens,Election Day,6019,Commissioner Of Insurance,5897,122
Pickens,Provisional,0,Commissioner Of Insurance,0,0
Pierce,Absentee by Mail,327,Commissioner Of Insurance,326,1
Pierce,Advance in Person,4598,Commissioner Of Insurance,4521,77
Pierce,Election Day,1958,Commissioner Of Insurance,1912,46
Pierce,Provisional,1,Commissioner Of Insurance,1,0
Pike,Absentee by Mail,304,Commissioner Of Insurance,300,4
Pike,Advance in Person,4478,Commissioner Of Insurance,4422,56
Pike,Election Day,3752,Commissioner Of Insurance,3683,69
Pike,Provisional,9,Commissioner Of Insurance,9,0
Polk,Absentee by Mail,447,Commissioner Of Insurance,444,3
Polk,Advance in Person,7744,Commissioner Of Insurance,7583,161
Polk,Election Day,4668,Commissioner Of Insurance,4555,113
Polk,Provisional,2,Commissioner Of Insurance,2,0
Pulaski,Absentee by Mail,232,Commissioner Of Insurance,220,12
Pulaski,Advance in Person,2522,Commissioner Of Insurance,2439,83
Pulaski,Election Day,868,Commissioner Of Insurance,817,51
Pulaski,Provisional,0,Commissioner Of Insurance,0,0
Putnam,Absentee by Mail,598,Commissioner Of Insurance,594,4
Putnam,Advance in Person,4858,Commissioner Of Insurance,4778,80
Putnam,Election Day,3865,Commissioner Of Insurance,3779,86
Putnam,Provisional,14,Commissioner Of Insurance,14,0
Quitman,Absentee by Mail,60,Commissioner Of Insurance,53,7
Quitman,Advance in Person,451,Commissioner Of Insurance,422,29
Quitman,Election Day,429,Commissioner Of Insurance,408,21
Quitman,Provisional,0,Commissioner Of Insurance,0,0
Rabun,Absentee by Mail,843,Commissioner Of Insurance,824,19
Rabun,Advance in Person,4889,Commissioner Of Insurance,4809,80
Rabun,Election Day,1846,Commissioner Of Insurance,1798,48
Rabun,Provisional,0,Commissioner Of Insurance,0,0
Randolph,Absentee by Mail,313,Commissioner Of Insurance,307,6
Randolph,Advance in Person,1232,Commissioner Of Insurance,1178,54
Randolph,Election Day,1243,Commissioner Of Insurance,1191,52
Randolph,Provisional,1,Commissioner Of Insurance,1,0
Richmond,Absentee by Mail,5314,Commissioner Of Insurance,5220,94
Richmond,Advance in Person,28737,Commissioner Of Insurance,28248,489
Richmond,Election Day,35992,Commissioner Of Insurance,35120,872
Richmond,Provisional,112,Commissioner Of Insurance,109,3
Rockdale,Absentee by Mail,1853,Commissioner Of Insurance,1834,19
Rockdale,Advance in Person,22789,Commissioner Of Insurance,22482,307
Rockdale,Election Day,11958,Commissioner Of Insurance,11749,209
Rockdale,Provisional,55,Commissioner Of Insurance,52,3
Schley,Absentee by Mail,96,Commissioner Of Insurance,96,0
Schley,Advance in Person,1321,Commissioner Of Insurance,1287,34
Schley,Election Day,514,Commissioner Of Insurance,489,25
Schley,Provisional,2,Commissioner Of Insurance,2,0
Screven,Absentee by Mail,271,Commissioner Of Insurance,267,4
Screven,Advance in Person,2674,Commissioner Of Insurance,2583,91
Screven,Election Day,2462,Commissioner Of Insurance,2377,85
Screven,Provisional,7,Commissioner Of Insurance,7,0
Seminole,Absentee by Mail,264,Commissioner Of Insurance,257,7
Seminole,Advance in Person,1078,Commissioner Of Insurance,1063,15
Seminole,Election Day,1872,Commissioner Of Insurance,1828,44
Seminole,Provisional,13,Commissioner Of Insurance,12,1
Spalding,Absentee by Mail,1283,Commissioner Of Insurance,1255,28
Spalding,Advance in Person,13046,Commissioner Of Insurance,12721,325
Spalding,Election Day,10056,Commissioner Of Insurance,9832,224
Spalding,Provisional,32,Commissioner Of Insurance,29,3
Stephens,Absentee by Mail,536,Commissioner Of Insurance,525,11
Stephens,Advance in Person,6139,Commissioner Of Insurance,6026,113
Stephens,Election Day,2394,Commissioner Of Insurance,2332,62
Stephens,Provisional,18,Commissioner Of Insurance,17,1
Stewart,Absentee by Mail,233,Commissioner Of Insurance,221,12
Stewart,Advance in Person,694,Commissioner Of Insurance,647,47
Stewart,Election Day,857,Commissioner Of Insurance,774,83
Stewart,Provisional,35,Commissioner Of Insurance,35,0
Sumter,Absentee by Mail,877,Commissioner Of Insurance,857,20
Sumter,Advance in Person,5531,Commissioner Of Insurance,5403,128
Sumter,Election Day,4148,Commissioner Of Insurance,4027,121
Sumter,Provisional,0,Commissioner Of Insurance,0,0
Talbot,Absentee by Mail,285,Commissioner Of Insurance,261,24
Talbot,Advance in Person,772,Commissioner Of Insurance,742,30
Talbot,Election Day,1895,Commissioner Of Insurance,1797,98
Talbot,Provisional,2,Commissioner Of Insurance,2,0
Taliaferro,Absentee by Mail,162,Commissioner Of Insurance,150,12
Taliaferro,Advance in Person,441,Commissioner Of Insurance,402,39
Taliaferro,Election Day,314,Commissioner Of Insurance,287,27
Taliaferro,Provisional,4,Commissioner Of Insurance,4,0
Tattnall,Absentee by Mail,392,Commissioner Of Insurance,387,5
Tattnall,Advance in Person,3539,Commissioner Of Insurance,3430,109
Tattnall,Election Day,2708,Commissioner Of Insurance,2611,97
Tattnall,Provisional,8,Commissioner Of Insurance,8,0
Taylor,Absentee by Mail,243,Commissioner Of Insurance,239,4
Taylor,Advance in Person,1843,Commissioner Of Insurance,1808,35
Taylor,Election Day,1179,Commissioner Of Insurance,1124,55
Taylor,Provisional,29,Commissioner Of Insurance,29,0
Telfair,Absentee by Mail,331,Commissioner Of Insurance,328,3
Telfair,Advance in Person,1676,Commissioner Of Insurance,1614,62
Telfair,Election Day,1624,Commissioner Of Insurance,1559,65
Telfair,Provisional,1,Commissioner Of Insurance,1,0
Terrell,Absentee by Mail,327,Commissioner Of Insurance,326,1
Terrell,Advance in Person,1612,Commissioner Of Insurance,1573,39
Terrell,Election Day,1991,Commissioner Of Insurance,1915,76
Terrell,Provisional,9,Commissioner Of Insurance,9,0
Thomas,Absentee by Mail,991,Commissioner Of Insurance,980,11
Thomas,Advance in Person,8376,Commissioner Of Insurance,8187,189
Thomas,Election Day,7874,Commissioner Of Insurance,7676,198
Thomas,Provisional,3,Commissioner Of Insurance,3,0
Tift,Absentee by Mail,561,Commissioner Of Insurance,551,10
Tift,Advance in Person,7646,Commissioner Of Insurance,7450,196
Tift,Election Day,5462,Commissioner Of Insurance,5289,173
Tift,Provisional,4,Commissioner Of Insurance,3,1
Toombs,Absentee by Mail,681,Commissioner Of Insurance,668,13
Toombs,Advance in Person,4860,Commissioner Of Insurance,4723,137
Toombs,Election Day,3310,Commissioner Of Insurance,3215,95
Toombs,Provisional,9,Commissioner Of Insurance,9,0
Towns,Absentee by Mail,284,Commissioner Of Insurance,276,8
Towns,Advance in Person,4009,Commissioner Of Insurance,3911,98
Towns,Election Day,1839,Commissioner Of Insurance,1800,39
Towns,Provisional,0,Commissioner Of Insurance,0,0
Treutlen,Absentee by Mail,146,Commissioner Of Insurance,138,8
Treutlen,Advance in Person,1659,Commissioner Of Insurance,1601,58
Treutlen,Election Day,805,Commissioner Of Insurance,776,29
Treutlen,Provisional,4,Commissioner Of Insurance,4,0
Troup,Absentee by Mail,1264,Commissioner Of Insurance,1240,24
Troup,Advance in Person,11226,Commissioner Of Insurance,11038,188
Troup,Election Day,11173,Commissioner Of Insurance,10905,268
Troup,Provisional,250,Commissioner Of Insurance,243,7
Turner,Absentee by Mail,148,Commissioner Of Insurance,148,0
Turner,Advance in Person,1922,Commissioner Of Insurance,1849,73
Turner,Election Day,1199,Commissioner Of Insurance,1160,39
Turner,Provisional,5,Commissioner Of Insurance,5,0
Twiggs,Absentee by Mail,275,Commissioner Of Insurance,272,3
Twiggs,Advance in Person,1531,Commissioner Of Insurance,1484,47
Twiggs,Election Day,1981,Commissioner Of Insurance,1912,69
Twiggs,Provisional,5,Commissioner Of Insurance,5,0
Union,Absentee by Mail,482,Commissioner Of Insurance,473,9
Union,Advance in Person,6626,Commissioner Of Insurance,6517,109
Union,Election Day,4755,Commissioner Of Insurance,4628,127
Union,Provisional,2,Commissioner Of Insurance,2,0
Upson,Absentee by Mail,602,Commissioner Of Insurance,591,11
Upson,Advance in Person,6729,Commissioner Of Insurance,6576,153
Upson,Election Day,3227,Commissioner Of Insurance,3136,91
Upson,Provisional,10,Commissioner Of Insurance,10,0
Walker,Absentee by Mail,813,Commissioner Of Insurance,800,13
Walker,Advance in Person,11133,Commissioner Of Insurance,10929,204
Walker,Election Day,9505,Commissioner Of Insurance,9276,229
Walker,Provisional,39,Commissioner Of Insurance,38,1
Walton,Absentee by Mail,1769,Commissioner Of Insurance,1745,24
Walton,Advance in Person,14370,Commissioner Of Insurance,14122,248
Walton,Election Day,22496,Commissioner Of Insurance,22092,404
Walton,Provisional,51,Commissioner Of Insurance,50,1
Ware,Absentee by Mail,627,Commissioner Of Insurance,619,8
Ware,Advance in Person,5460,Commissioner Of Insurance,5374,86
Ware,Election Day,4917,Commissioner Of Insurance,4814,103
Ware,Provisional,12,Commissioner Of Insurance,12,0
Warren,Absentee by Mail,187,Commissioner Of Insurance,184,3
Warren,Advance in Person,1267,Commissioner Of Insurance,1226,41
Warren,Election Day,806,Commissioner Of Insurance,774,32
Warren,Provisional,1,Commissioner Of Insurance,1,0
Washington,Absentee by Mail,727,Commissioner Of Insurance,703,24
Washington,Advance in Person,3907,Commissioner Of Insurance,3765,142
Washington,Election Day,3525,Commissioner Of Insurance,3365,160
Washington,Provisional,10,Commissioner Of Insurance,10,0
Wayne,Absentee by Mail,501,Commissioner Of Insurance,496,5
Wayne,Advance in Person,5868,Commissioner Of Insurance,5726,142
Wayne,Election Day,3753,Commissioner Of Insurance,3653,100
Wayne,Provisional,10,Commissioner Of Insurance,9,1
Webster,Absentee by Mail,152,Commissioner Of Insurance,149,3
Webster,Advance in Person,544,Commissioner Of Insurance,528,16
Webster,Election Day,404,Commissioner Of Insurance,383,21
Webster,Provisional,0,Commissioner Of Insurance,0,0
Wheeler,Absentee by Mail,115,Commissioner Of Insurance,115,0
Wheeler,Advance in Person,974,Commissioner Of Insurance,947,27
Wheeler,Election Day,838,Commissioner Of Insurance,796,42
Wheeler,Provisional,4,Commissioner Of Insurance,4,0
White,Absentee by Mail,537,Commissioner Of Insurance,532,5
White,Advance in Person,5408,Commissioner Of Insurance,5312,96
White,Election Day,5489,Commissioner Of Insurance,5406,83
White,Provisional,6,Commissioner Of Insurance,6,0
Whitfield,Absentee by Mail,1017,Commissioner Of Insurance,1005,12
Whitfield,Advance in Person,9610,Commissioner Of Insurance,9411,199
Whitfield,Election Day,16675,Commissioner Of Insurance,16184,491
Whitfield,Provisional,25,Commissioner Of Insurance,24,1
Wilcox,Absentee by Mail,205,Commissioner Of Insurance,199,6
Wilcox,Advance in Person,1202,Commissioner Of Insurance,1169,33
Wilcox,Election Day,1408,Commissioner Of Insurance,1360,48
Wilcox,Provisional,0,Commissioner Of Insurance,0,0
Wilkes,Absentee by Mail,301,Commissioner Of Insurance,293,8
Wilkes,Advance in Person,2075,Commissioner Of Insurance,1999,76
Wilkes,Election Day,1995,Commissioner Of Insurance,1909,86
Wilkes,Provisional,6,Commissioner Of Insurance,6,0
Wilkinson,Absentee by Mail,270,Commissioner Of Insurance,263,7
Wilkinson,Advance in Person,1567,Commissioner Of Insurance,1525,42
Wilkinson,Election Day,2427,Commissioner Of Insurance,2340,87
Wilkinson,Provisional,1,Commissioner Of Insurance,1,0
Worth,Absentee by Mail,305,Commissioner Of Insurance,300,5
Worth,Advance in Person,3108,Commissioner Of Insurance,3049,59
Worth,Election Day,4418,Commissioner Of Insurance,4292,126
Worth,Provisional,15,Commissioner Of Insurance,15,0
Appling,Absentee by Mail,530,State School Superintendent,518,12
Appling,Advance in Person,3298,State School Superintendent,3208,90
Appling,Election Day,2978,State School Superintendent,2885,93
Appling,Provisional,3,State School Superintendent,3,0
Atkinson,Absentee by Mail,88,State School Superintendent,88,0
Atkinson,Advance in Person,1285,State School Superintendent,1232,53
Atkinson,Election Day,1147,State School Superintendent,1087,60
Atkinson,Provisional,2,State School Superintendent,2,0
Bacon,Absentee by Mail,174,State School Superintendent,172,2
Bacon,Advance in Person,2828,State School Superintendent,2770,58
Bacon,Election Day,827,State School Superintendent,790,37
Bacon,Provisional,1,State School Superintendent,1,0
Baker,Absentee by Mail,141,State School Superintendent,135,6
Baker,Advance in Person,485,State School Superintendent,463,22
Baker,Election Day,665,State School Superintendent,636,29
Baker,Provisional,2,State School Superintendent,2,0
Baldwin,Absentee by Mail,1158,State School Superintendent,1143,15
Baldwin,Advance in Person,8295,State School Superintendent,8078,217
Baldwin,Election Day,6180,State School Superintendent,5981,199
Baldwin,Provisional,3,State School Superintendent,3,0
Banks,Absentee by Mail,223,State School Superintendent,218,5
Banks,Advance in Person,2771,State School Superintendent,2725,46
Banks,Election Day,3858,State School Superintendent,3782,76
Banks,Provisional,1,State School Superintendent,1,0
Barrow,Absentee by Mail,1263,State School Superintendent,1235,28
Barrow,Advance in Person,12223,State School Superintendent,12050,173
Barrow,Election Day,13912,State School Superintendent,13649,263
Barrow,Provisional,7,State School Superintendent,7,0
Bartow,Absentee by Mail,1568,State School Superintendent,1555,13
Bartow,Advance in Person,16175,State School Superintendent,15856,319
Bartow,Election Day,19584,State School Superintendent,19130,454
Bartow,Provisional,32,State School Superintendent,32,0
Ben Hill,Absentee by Mail,320,State School Superintendent,315,5
Ben Hill,Advance in Person,3605,State School Superintendent,3553,52
Ben Hill,Election Day,1608,State School Superintendent,1572,36
Ben Hill,Provisional,14,State School Superintendent,14,0
Berrien,Absentee by Mail,322,State School Superintendent,320,2
Berrien,Advance in Person,3153,State School Superintendent,3099,54
Berrien,Election Day,2772,State School Superintendent,2704,68
Berrien,Provisional,5,State School Superintendent,4,1
Bibb,Absentee by Mail,4461,State School Superintendent,4399,62
Bibb,Advance in Person,26183,State School Superintendent,25646,537
Bibb,Election Day,29816,State School Superintendent,29148,668
Bibb,Provisional,232,State School Superintendent,228,4
Bleckley,Absentee by Mail,257,State School Superintendent,251,6
Bleckley,Advance in Person,2805,State School Superintendent,2740,65
Bleckley,Election Day,1793,State School Superintendent,1738,55
Bleckley,Provisional,5,State School Superintendent,5,0
Brantley,Absentee by Mail,188,State School Superintendent,185,3
Brantley,Advance in Person,2868,State School Superintendent,2825,43
Brantley,Election Day,2633,State School Superintendent,2562,71
Brantley,Provisional,5,State School Superintendent,4,1
Brooks,Absentee by Mail,465,State School Superintendent,451,14
Brooks,Advance in Person,2417,State School Superintendent,2371,46
Brooks,Election Day,2814,State School Superintendent,2737,77
Brooks,Provisional,27,State School Superintendent,26,1
Bryan,Absentee by Mail,582,State School Superintendent,575,7
Bryan,Advance in Person,8342,State School Superintendent,8218,124
Bryan,Election Day,6046,State School Superintendent,5932,114
Bryan,Provisional,15,State School Superintendent,15,0
Bulloch,Absentee by Mail,1076,State School Superintendent,1052,24
Bulloch,Advance in Person,11170,State School Superintendent,10954,216
Bulloch,Election Day,11297,State School Superintendent,11048,249
Bulloch,Provisional,140,State School Superintendent,134,6
Burke,Absentee by Mail,968,State School Superintendent,957,11
Burke,Advance in Person,3199,State School Superintendent,3137,62
Burke,Election Day,4552,State School Superintendent,4440,112
Burke,Provisional,2,State School Superintendent,2,0
Butts,Absentee by Mail,380,State School Superintendent,371,9
Butts,Advance in Person,6277,State School Superintendent,6160,117
Butts,Election Day,2206,State School Superintendent,2152,54
Butts,Provisional,0,State School Superintendent,0,0
Calhoun,Absentee by Mail,185,State School Superintendent,181,4
Calhoun,Advance in Person,607,State School Superintendent,597,10
Calhoun,Election Day,1107,State School Superintendent,1082,25
Calhoun,Provisional,0,State School Superintendent,0,0
Camden,Absentee by Mail,1193,State School Superintendent,1168,25
Camden,Advance in Person,8085,State School Superintendent,7975,110
Camden,Election Day,7775,State School Superintendent,7614,161
Camden,Provisional,8,State School Superintendent,8,0
Candler,Absentee by Mail,120,State School Superintendent,118,2
Candler,Advance in Person,2335,State School Superintendent,2279,56
Candler,Election Day,1083,State School Superintendent,1059,24
Candler,Provisional,1,State School Superintendent,1,0
Carroll,Absentee by Mail,1518,State School Superintendent,1494,24
Carroll,Advance in Person,20100,State School Superintendent,19805,295
Carroll,Election Day,20121,State School Superintendent,19692,429
Carroll,Provisional,104,State School Superintendent,101,3
Catoosa,Absentee by Mail,540,State School Superintendent,532,8
Catoosa,Advance in Person,13673,State School Superintendent,13472,201
Catoosa,Election Day,9512,State School Superintendent,9360,152
Catoosa,Provisional,33,State School Superintendent,33,0
Charlton,Absentee by Mail,163,State School Superintendent,162,1
Charlton,Advance in Person,1549,State School Superintendent,1531,18
Charlton,Election Day,1657,State School Superintendent,1612,45
Charlton,Provisional,8,State School Superintendent,8,0
Chatham,Absentee by Mail,6177,State School Superintendent,6048,129
Chatham,Advance in Person,32338,State School Superintendent,31826,512
Chatham,Election Day,64823,State School Superintendent,63382,1441
Chatham,Provisional,205,State School Superintendent,202,3
Chattahoochee,Absentee by Mail,35,State School Superintendent,35,0
Chattahoochee,Advance in Person,493,State School Superintendent,478,15
Chattahoochee,Election Day,574,State School Superintendent,556,18
Chattahoochee,Provisional,3,State School Superintendent,3,0
Chattooga,Absentee by Mail,225,State School Superintendent,223,2
Chattooga,Advance in Person,3452,State School Superintendent,3377,75
Chattooga,Election Day,3750,State School Superintendent,3659,91
Chattooga,Provisional,7,State School Superintendent,7,0
Cherokee,Absentee by Mail,5312,State School Superintendent,5211,101
Cherokee,Advance in Person,48565,State School Superintendent,47917,648
Cherokee,Election Day,52422,State School Superintendent,51326,1096
Cherokee,Provisional,112,State School Superintendent,107,5
Clarke,Absentee by Mail,3022,State School Superintendent,2952,70
Clarke,Advance in Person,19957,State School Superintendent,19616,341
Clarke,Election Day,20282,State School Superintendent,19715,567
Clarke,Provisional,41,State School Superintendent,40,1
Clay,Absentee by Mail,143,State School Superintendent,136,7
Clay,Advance in Person,579,State School Superintendent,571,8
Clay,Election Day,464,State School Superintendent,455,9
Clay,Provisional,0,State School Superintendent,0,0
Clayton,Absentee by Mail,5847,State School Superintendent,5732,115
Clayton,Advance in Person,47671,State School Superintendent,46950,721
Clayton,Election Day,38322,State School Superintendent,37604,718
Clayton,Provisional,372,State School Superintendent,350,22
Clinch,Absentee by Mail,109,State School Superintendent,107,2
Clinch,Advance in Person,1236,State School Superintendent,1189,47
Clinch,Election Day,909,State School Superintendent,870,39
Clinch,Provisional,4,State School Superintendent,4,0
Cobb,Absentee by Mail,25901,State School Superintendent,25328,573
Cobb,Advance in Person,111554,State School Superintendent,110165,1389
Cobb,Election Day,172926,State School Superintendent,169648,3278
Cobb,Provisional,1433,State School Superintendent,1376,57
Coffee,Absentee by Mail,395,State School Superintendent,388,7
Coffee,Advance in Person,7664,State School Superintendent,7485,179
Coffee,Election Day,4536,State School Superintendent,4405,131
Coffee,Provisional,20,State School Superintendent,19,1
Colquitt,Absentee by Mail,514,State School Superintendent,504,10
Colquitt,Advance in Person,6071,State School Superintendent,5917,154
Colquitt,Election Day,6368,State School Superintendent,6190,178
Colquitt,Provisional,10,State School Superintendent,10,0
Columbia,Absentee by Mail,2936,State School Superintendent,2867,69
Columbia,Advance in Person,29686,State School Superintendent,29372,314
Columbia,Election Day,28969,State School Superintendent,28494,475
Columbia,Provisional,43,State School Superintendent,42,1
Cook,Absentee by Mail,244,State School Superintendent,243,1
Cook,Advance in Person,3069,State School Superintendent,3031,38
Cook,Election Day,2490,State School Superintendent,2450,40
Cook,Provisional,0,State School Superintendent,0,0
Coweta,Absentee by Mail,2812,State School Superintendent,2774,38
Coweta,Advance in Person,25641,State School Superintendent,25272,369
Coweta,Election Day,29603,State School Superintendent,29064,539
Coweta,Provisional,15,State School Superintendent,15,0
Crawford,Absentee by Mail,234,State School Superintendent,226,8
Crawford,Advance in Person,2567,State School Superintendent,2493,74
Crawford,Election Day,2130,State School Superintendent,2080,50
Crawford,Provisional,3,State School Superintendent,3,0
Crisp,Absentee by Mail,363,State School Superintendent,354,9
Crisp,Advance in Person,4191,State School Superintendent,4060,131
Crisp,Election Day,2470,State School Superintendent,2360,110
Crisp,Provisional,26,State School Superintendent,23,3
Dade,Absentee by Mail,129,State School Superintendent,124,5
Dade,Advance in Person,2561,State School Superintendent,2488,73
Dade,Election Day,2760,State School Superintendent,2683,77
Dade,Provisional,12,State School Superintendent,12,0
Dawson,Absentee by Mail,439,State School Superintendent,432,7
Dawson,Advance in Person,7020,State School Superintendent,6912,108
Dawson,Election Day,4111,State School Superintendent,4026,85
Dawson,Provisional,11,State School Superintendent,11,0
DeKalb,Absentee by Mail,19672,State School Superintendent,19028,644
DeKalb,Advance in Person,150814,State School Superintendent,148099,2715
DeKalb,Election Day,140482,State School Superintendent,136828,3654
DeKalb,Provisional,1773,State School Superintendent,1716,57
Decatur,Absentee by Mail,548,State School Superintendent,541,7
Decatur,Advance in Person,4260,State School Superintendent,4169,91
Decatur,Election Day,4235,State School Superintendent,4134,101
Decatur,Provisional,103,State School Superintendent,97,6
Dodge,Absentee by Mail,448,State School Superintendent,433,15
Dodge,Advance in Person,3411,State School Superintendent,3264,147
Dodge,Election Day,3192,State School Superintendent,3051,141
Dodge,Provisional,10,State School Superintendent,10,0
Dooly,Absentee by Mail,196,State School Superintendent,189,7
Dooly,Advance in Person,1889,State School Superintendent,1818,71
Dooly,Election Day,1708,State School Superintendent,1639,69
Dooly,Provisional,2,State School Superintendent,1,1
Dougherty,Absentee by Mail,1944,State School Superintendent,1900,44
Dougherty,Advance in Person,11332,State School Superintendent,11151,181
Dougherty,Election Day,18021,State School Superintendent,17637,384
Dougherty,Provisional,128,State School Superintendent,122,6
Douglas,Absentee by Mail,3233,State School Superintendent,3184,49
Douglas,Advance in Person,30219,State School Superintendent,29859,360
Douglas,Election Day,21745,State School Superintendent,21415,330
Douglas,Provisional,58,State School Superintendent,58,0
Early,Absentee by Mail,473,State School Superintendent,459,14
Early,Advance in Person,1569,State School Superintendent,1549,20
Early,Election Day,2089,State School Superintendent,2046,43
Early,Provisional,4,State School Superintendent,4,0
Echols,Absentee by Mail,35,State School Superintendent,35,0
Echols,Advance in Person,767,State School Superintendent,747,20
Echols,Election Day,341,State School Superintendent,331,10
Echols,Provisional,0,State School Superintendent,0,0
Effingham,Absentee by Mail,750,State School Superintendent,744,6
Effingham,Advance in Person,10717,State School Superintendent,10562,155
Effingham,Election Day,11898,State School Superintendent,11688,210
Effingham,Provisional,6,State School Superintendent,6,0
Elbert,Absentee by Mail,563,State School Superintendent,559,4
Elbert,Advance in Person,3722,State School Superintendent,3676,46
Elbert,Election Day,3034,State School Superintendent,2994,40
Elbert,Provisional,69,State School Superintendent,69,0
Emanuel,Absentee by Mail,390,State School Superintendent,379,11
Emanuel,Advance in Person,3424,State School Superintendent,3335,89
Emanuel,Election Day,3896,State School Superintendent,3750,146
Emanuel,Provisional,6,State School Superintendent,6,0
Evans,Absentee by Mail,199,State School Superintendent,194,5
Evans,Advance in Person,2162,State School Superintendent,2096,66
Evans,Election Day,1086,State School Superintendent,1049,37
Evans,Provisional,0,State School Superintendent,0,0
Fannin,Absentee by Mail,658,State School Superintendent,641,17
Fannin,Advance in Person,5341,State School Superintendent,5252,89
Fannin,Election Day,5204,State School Superintendent,5066,138
Fannin,Provisional,16,State School Superintendent,16,0
Fayette,Absentee by Mail,2647,State School Superintendent,2595,52
Fayette,Advance in Person,31073,State School Superintendent,30695,378
Fayette,Election Day,24242,State School Superintendent,23743,499
Fayette,Provisional,36,State School Superintendent,35,1
Floyd,Absentee by Mail,1260,State School Superintendent,1237,23
Floyd,Advance in Person,13688,State School Superintendent,13482,206
Floyd,Election Day,15277,State School Superintendent,14936,341
Floyd,Provisional,113,State School Superintendent,113,0
Forsyth,Absentee by Mail,4428,State School Superintendent,4335,93
Forsyth,Advance in Person,52559,State School Superintendent,51873,686
Forsyth,Election Day,36252,State School Superintendent,35583,669
Forsyth,Provisional,59,State School Superintendent,59,0
Franklin,Absentee by Mail,388,State School Superintendent,388,0
Franklin,Advance in Person,3502,State School Superintendent,3456,46
Franklin,Election Day,4259,State School Superintendent,4164,95
Franklin,Provisional,0,State School Superintendent,0,0
Fulton,Absentee by Mail,17842,State School Superintendent,17291,551
Fulton,Advance in Person,224522,State School Superintendent,220033,4489
Fulton,Election Day,179442,State School Superintendent,174426,5016
Fulton,Provisional,1982,State School Superintendent,1882,100
Gilmer,Absentee by Mail,559,State School Superintendent,554,5
Gilmer,Advance in Person,6295,State School Superintendent,6170,125
Gilmer,Election Day,5617,State School Superintendent,5475,142
Gilmer,Provisional,39,State School Superintendent,37,2
Glascock,Absentee by Mail,81,State School Superintendent,80,1
Glascock,Advance in Person,652,State School Superintendent,631,21
Glascock,Election Day,567,State School Superintendent,535,32
Glascock,Provisional,1,State School Superintendent,1,0
Glynn,Absentee by Mail,1812,State School Superintendent,1789,23
Glynn,Advance in Person,17510,State School Superintendent,17232,278
Glynn,Election Day,13179,State School Superintendent,12908,271
Glynn,Provisional,147,State School Superintendent,142,5
Gordon,Absentee by Mail,547,State School Superintendent,530,17
Gordon,Advance in Person,8119,State School Superintendent,7941,178
Gordon,Election Day,9106,State School Superintendent,8895,211
Gordon,Provisional,32,State School Superintendent,30,2
Grady,Absentee by Mail,400,State School Superintendent,392,8
Grady,Advance in Person,3857,State School Superintendent,3805,52
Grady,Election Day,4099,State School Superintendent,4025,74
Grady,Provisional,14,State School Superintendent,14,0
Greene,Absentee by Mail,623,State School Superintendent,612,11
Greene,Advance in Person,5593,State School Superintendent,5536,57
Greene,Election Day,2773,State School Superintendent,2712,61
Greene,Provisional,6,State School Superintendent,6,0
Gwinnett,Absentee by Mail,20397,State School Superintendent,20133,264
Gwinnett,Advance in Person,137166,State School Superintendent,135452,1714
Gwinnett,Election Day,155146,State School Superintendent,152525,2621
Gwinnett,Provisional,2209,State School Superintendent,2140,69
Habersham,Absentee by Mail,853,State School Superintendent,837,16
Habersham,Advance in Person,10023,State School Superintendent,9847,176
Habersham,Election Day,4619,State School Superintendent,4503,116
Habersham,Provisional,5,State School Superintendent,5,0
Hall,Absentee by Mail,3493,State School Superintendent,3423,70
Hall,Advance in Person,24348,State School Superintendent,23931,417
Hall,Election Day,39441,State School Superintendent,38646,795
Hall,Provisional,124,State School Superintendent,117,7
Hancock,Absentee by Mail,490,State School Superintendent,474,16
Hancock,Advance in Person,1531,State School Superintendent,1474,57
Hancock,Election Day,1518,State School Superintendent,1438,80
Hancock,Provisional,9,State School Superintendent,8,1
Haralson,Absentee by Mail,393,State School Superintendent,390,3
Haralson,Advance in Person,4202,State School Superintendent,4122,80
Haralson,Election Day,5990,State School Superintendent,5881,109
Haralson,Provisional,0,State School Superintendent,0,0
Harris,Absentee by Mail,729,State School Superintendent,715,14
Harris,Advance in Person,7251,State School Superintendent,7157,94
Harris,Election Day,7992,State School Superintendent,7831,161
Harris,Provisional,14,State School Superintendent,14,0
Hart,Absentee by Mail,440,State School Superintendent,434,6
Hart,Advance in Person,5220,State School Superintendent,5101,119
Hart,Election Day,3958,State School Superintendent,3870,88
Hart,Provisional,4,State School Superintendent,4,0
Heard,Absentee by Mail,278,State School Superintendent,272,6
Heard,Advance in Person,1427,State School Superintendent,1399,28
Heard,Election Day,2346,State School Superintendent,2297,49
Heard,Provisional,4,State School Superintendent,4,0
Henry,Absentee by Mail,4997,State School Superintendent,4904,93
Henry,Advance in Person,58658,State School Superintendent,57957,701
Henry,Election Day,34710,State School Superintendent,34151,559
Henry,Provisional,193,State School Superintendent,186,7
Houston,Absentee by Mail,3190,State School Superintendent,3132,58
Houston,Advance in Person,34816,State School Superintendent,34388,428
Houston,Election Day,21152,State School Superintendent,20767,385
Houston,Provisional,74,State School Superintendent,68,6
Irwin,Absentee by Mail,133,State School Superintendent,132,1
Irwin,Advance in Person,2048,State School Superintendent,2004,44
Irwin,Election Day,1375,State School Superintendent,1354,21
Irwin,Provisional,8,State School Superintendent,8,0
Jackson,Absentee by Mail,1019,State School Superintendent,1005,14
Jackson,Advance in Person,14919,State School Superintendent,14745,174
Jackson,Election Day,10951,State School Superintendent,10761,190
Jackson,Provisional,10,State School Superintendent,9,1
Jasper,Absentee by Mail,421,State School Superintendent,416,5
Jasper,Advance in Person,2981,State School Superintendent,2932,49
Jasper,Election Day,2505,State School Superintendent,2451,54
Jasper,Provisional,38,State School Superintendent,37,1
Jeff Davis,Absentee by Mail,229,State School Superintendent,224,5
Jeff Davis,Advance in Person,2680,State School Superintendent,2592,88
Jeff Davis,Election Day,1906,State School Superintendent,1816,90
Jeff Davis,Provisional,0,State School Superintendent,0,0
Jefferson,Absentee by Mail,607,State School Superintendent,594,13
Jefferson,Advance in Person,2803,State School Superintendent,2709,94
Jefferson,Election Day,3346,State School Superintendent,3228,118
Jefferson,Provisional,11,State School Superintendent,10,1
Jenkins,Absentee by Mail,188,State School Superintendent,184,4
Jenkins,Advance in Person,1557,State School Superintendent,1511,46
Jenkins,Election Day,1111,State School Superintendent,1088,23
Jenkins,Provisional,16,State School Superintendent,16,0
Johnson,Absentee by Mail,236,State School Superintendent,223,13
Johnson,Advance in Person,1970,State School Superintendent,1900,70
Johnson,Election Day,1277,State School Superintendent,1215,62
Johnson,Provisional,0,State School Superintendent,0,0
Jones,Absentee by Mail,784,State School Superintendent,766,18
Jones,Advance in Person,6968,State School Superintendent,6851,117
Jones,Election Day,4680,State School Superintendent,4590,90
Jones,Provisional,9,State School Superintendent,9,0
Lamar,Absentee by Mail,404,State School Superintendent,396,8
Lamar,Advance in Person,3820,State School Superintendent,3741,79
Lamar,Election Day,3122,State School Superintendent,3067,55
Lamar,Provisional,11,State School Superintendent,11,0
Lanier,Absentee by Mail,108,State School Superintendent,105,3
Lanier,Advance in Person,1661,State School Superintendent,1612,49
Lanier,Election Day,910,State School Superintendent,865,45
Lanier,Provisional,2,State School Superintendent,2,0
Laurens,Absentee by Mail,1286,State School Superintendent,1251,35
Laurens,Advance in Person,8485,State School Superintendent,8290,195
Laurens,Election Day,9168,State School Superintendent,8916,252
Laurens,Provisional,13,State School Superintendent,13,0
Lee,Absentee by Mail,480,State School Superintendent,474,6
Lee,Advance in Person,5681,State School Superintendent,5607,74
Lee,Election Day,7388,State School Superintendent,7272,116
Lee,Provisional,6,State School Superintendent,6,0
Liberty,Absentee by Mail,950,State School Superintendent,937,13
Liberty,Advance in Person,8143,State School Superintendent,8038,105
Liberty,Election Day,6265,State School Superintendent,6162,103
Liberty,Provisional,10,State School Superintendent,10,0
Lincoln,Absentee by Mail,350,State School Superintendent,347,3
Lincoln,Advance in Person,1937,State School Superintendent,1902,35
Lincoln,Election Day,1680,State School Superintendent,1635,45
Lincoln,Provisional,2,State School Superintendent,2,0
Long,Absentee by Mail,169,State School Superintendent,166,3
Long,Advance in Person,1971,State School Superintendent,1929,42
Long,Election Day,1848,State School Superintendent,1795,53
Long,Provisional,10,State School Superintendent,9,1
Lowndes,Absentee by Mail,1890,State School Superintendent,1850,40
Lowndes,Advance in Person,21238,State School Superintendent,20993,245
Lowndes,Election Day,12084,State School Superintendent,11838,246
Lowndes,Provisional,541,State School Superintendent,517,24
Lumpkin,Absentee by Mail,467,State School Superintendent,456,11
Lumpkin,Advance in Person,7377,State School Superintendent,7260,117
Lumpkin,Election Day,3707,State School Superintendent,3613,94
Lumpkin,Provisional,7,State School Superintendent,7,0
Macon,Absentee by Mail,331,State School Superintendent,319,12
Macon,Advance in Person,2251,State School Superintendent,2154,97
Macon,Election Day,1635,State School Superintendent,1574,61
Macon,Provisional,0,State School Superintendent,0,0
Madison,Absentee by Mail,527,State School Superintendent,520,7
Madison,Advance in Person,5242,State School Superintendent,5139,103
Madison,Election Day,5928,State School Superintendent,5802,126
Madison,Provisional,2,State School Superintendent,2,0
Marion,Absentee by Mail,241,State School Superintendent,240,1
Marion,Advance in Person,1222,State School Superintendent,1190,32
Marion,Election Day,1467,State School Superintendent,1429,38
Marion,Provisional,1,State School Superintendent,1,0
McDuffie,Absentee by Mail,868,State School Superintendent,853,15
McDuffie,Advance in Person,5045,State School Superintendent,4967,78
McDuffie,Election Day,2879,State School Superintendent,2824,55
McDuffie,Provisional,0,State School Superintendent,0,0
McIntosh,Absentee by Mail,440,State School Superintendent,418,22
McIntosh,Advance in Person,2945,State School Superintendent,2802,143
McIntosh,Election Day,2023,State School Superintendent,1900,123
McIntosh,Provisional,0,State School Superintendent,0,0
Meriwether,Absentee by Mail,483,State School Superintendent,478,5
Meriwether,Advance in Person,2831,State School Superintendent,2772,59
Meriwether,Election Day,5325,State School Superintendent,5200,125
Meriwether,Provisional,11,State School Superintendent,10,1
Miller,Absentee by Mail,132,State School Superintendent,124,8
Miller,Advance in Person,1029,State School Superintendent,979,50
Miller,Election Day,1152,State School Superintendent,1095,57
Miller,Provisional,2,State School Superintendent,2,0
Mitchell,Absentee by Mail,564,State School Superintendent,552,12
Mitchell,Advance in Person,3343,State School Superintendent,3277,66
Mitchell,Election Day,3539,State School Superintendent,3465,74
Mitchell,Provisional,9,State School Superintendent,9,0
Monroe,Absentee by Mail,696,State School Superintendent,688,8
Monroe,Advance in Person,6311,State School Superintendent,6168,143
Monroe,Election Day,5925,State School Superintendent,5791,134
Monroe,Provisional,10,State School Superintendent,10,0
Montgomery,Absentee by Mail,211,State School Superintendent,206,5
Montgomery,Advance in Person,1416,State School Superintendent,1374,42
Montgomery,Election Day,1901,State School Superintendent,1817,84
Montgomery,Provisional,0,State School Superintendent,0,0
Morgan,Absentee by Mail,410,State School Superintendent,398,12
Morgan,Advance in Person,5406,State School Superintendent,5288,118
Morgan,Election Day,3738,State School Superintendent,3663,75
Morgan,Provisional,4,State School Superintendent,4,0
Murray,Absentee by Mail,265,State School Superintendent,254,11
Murray,Advance in Person,5111,State School Superintendent,4982,129
Murray,Election Day,5715,State School Superintendent,5585,130
Murray,Provisional,0,State School Superintendent,0,0
Muscogee,Absentee by Mail,4422,State School Superintendent,4346,76
Muscogee,Advance in Person,27700,State School Superintendent,27226,474
Muscogee,Election Day,31019,State School Superintendent,30399,620
Muscogee,Provisional,131,State School Superintendent,127,4
Newton,Absentee by Mail,2735,State School Superintendent,2690,45
Newton,Advance in Person,19236,State School Superintendent,18938,298
Newton,Election Day,21158,State School Superintendent,20789,369
Newton,Provisional,12,State School Superintendent,11,1
Oconee,Absentee by Mail,931,State School Superintendent,912,19
Oconee,Advance in Person,11688,State School Superintendent,11490,198
Oconee,Election Day,8114,State School Superintendent,7920,194
Oconee,Provisional,11,State School Superintendent,11,0
Oglethorpe,Absentee by Mail,409,State School Superintendent,402,7
Oglethorpe,Advance in Person,3417,State School Superintendent,3348,69
Oglethorpe,Election Day,2658,State School Superintendent,2593,65
Oglethorpe,Provisional,1,State School Superintendent,1,0
Paulding,Absentee by Mail,3307,State School Superintendent,3249,58
Paulding,Advance in Person,32842,State School Superintendent,32383,459
Paulding,Election Day,25073,State School Superintendent,24631,442
Paulding,Provisional,83,State School Superintendent,80,3
Peach,Absentee by Mail,445,State School Superintendent,437,8
Peach,Advance in Person,6720,State School Superintendent,6598,122
Peach,Election Day,3190,State School Superintendent,3121,69
Peach,Provisional,90,State School Superintendent,87,3
Pickens,Absentee by Mail,222,State School Superintendent,215,7
Pickens,Advance in Person,7121,State School Superintendent,6982,139
Pickens,Election Day,6019,State School Superintendent,5884,135
Pickens,Provisional,0,State School Superintendent,0,0
Pierce,Absentee by Mail,327,State School Superintendent,324,3
Pierce,Advance in Person,4598,State School Superintendent,4541,57
Pierce,Election Day,1958,State School Superintendent,1926,32
Pierce,Provisional,1,State School Superintendent,1,0
Pike,Absentee by Mail,304,State School Superintendent,298,6
Pike,Advance in Person,4478,State School Superintendent,4431,47
Pike,Election Day,3752,State School Superintendent,3675,77
Pike,Provisional,9,State School Superintendent,9,0
Polk,Absentee by Mail,447,State School Superintendent,440,7
Polk,Advance in Person,7744,State School Superintendent,7607,137
Polk,Election Day,4668,State School Superintendent,4556,112
Polk,Provisional,2,State School Superintendent,2,0
Pulaski,Absentee by Mail,232,State School Superintendent,218,14
Pulaski,Advance in Person,2522,State School Superintendent,2438,84
Pulaski,Election Day,868,State School Superintendent,824,44
Pulaski,Provisional,0,State School Superintendent,0,0
Putnam,Absentee by Mail,598,State School Superintendent,592,6
Putnam,Advance in Person,4858,State School Superintendent,4781,77
Putnam,Election Day,3865,State School Superintendent,3766,99
Putnam,Provisional,14,State School Superintendent,14,0
Quitman,Absentee by Mail,60,State School Superintendent,51,9
Quitman,Advance in Person,451,State School Superintendent,432,19
Quitman,Election Day,429,State School Superintendent,409,20
Quitman,Provisional,0,State School Superintendent,0,0
Rabun,Absentee by Mail,843,State School Superintendent,819,24
Rabun,Advance in Person,4889,State School Superintendent,4781,108
Rabun,Election Day,1846,State School Superintendent,1800,46
Rabun,Provisional,0,State School Superintendent,0,0
Randolph,Absentee by Mail,313,State School Superintendent,309,4
Randolph,Advance in Person,1232,State School Superintendent,1200,32
Randolph,Election Day,1243,State School Superintendent,1201,42
Randolph,Provisional,1,State School Superintendent,1,0
Richmond,Absentee by Mail,5314,State School Superintendent,5230,84
Richmond,Advance in Person,28737,State School Superintendent,28299,438
Richmond,Election Day,35992,State School Superintendent,35226,766
Richmond,Provisional,112,State School Superintendent,109,3
Rockdale,Absentee by Mail,1853,State School Superintendent,1824,29
Rockdale,Advance in Person,22789,State School Superintendent,22512,277
Rockdale,Election Day,11958,State School Superintendent,11746,212
Rockdale,Provisional,55,State School Superintendent,51,4
Schley,Absentee by Mail,96,State School Superintendent,95,1
Schley,Advance in Person,1321,State School Superintendent,1284,37
Schley,Election Day,514,State School Superintendent,499,15
Schley,Provisional,2,State School Superintendent,2,0
Screven,Absentee by Mail,271,State School Superintendent,262,9
Screven,Advance in Person,2674,State School Superintendent,2609,65
Screven,Election Day,2462,State School Superintendent,2380,82
Screven,Provisional,7,State School Superintendent,7,0
Seminole,Absentee by Mail,264,State School Superintendent,258,6
Seminole,Advance in Person,1078,State School Superintendent,1064,14
Seminole,Election Day,1872,State School Superintendent,1828,44
Seminole,Provisional,13,State School Superintendent,12,1
Spalding,Absentee by Mail,1283,State School Superintendent,1246,37
Spalding,Advance in Person,13046,State School Superintendent,12717,329
Spalding,Election Day,10056,State School Superintendent,9821,235
Spalding,Provisional,32,State School Superintendent,28,4
Stephens,Absentee by Mail,536,State School Superintendent,529,7
Stephens,Advance in Person,6139,State School Superintendent,6045,94
Stephens,Election Day,2394,State School Superintendent,2333,61
Stephens,Provisional,18,State School Superintendent,17,1
Stewart,Absentee by Mail,233,State School Superintendent,220,13
Stewart,Advance in Person,694,State School Superintendent,653,41
Stewart,Election Day,857,State School Superintendent,787,70
Stewart,Provisional,35,State School Superintendent,34,1
Sumter,Absentee by Mail,877,State School Superintendent,863,14
Sumter,Advance in Person,5531,State School Superintendent,5407,124
Sumter,Election Day,4148,State School Superintendent,4034,114
Sumter,Provisional,0,State School Superintendent,0,0
Talbot,Absentee by Mail,285,State School Superintendent,264,21
Talbot,Advance in Person,772,State School Superintendent,745,27
Talbot,Election Day,1895,State School Superintendent,1810,85
Talbot,Provisional,2,State School Superintendent,2,0
Taliaferro,Absentee by Mail,162,State School Superintendent,143,19
Taliaferro,Advance in Person,441,State School Superintendent,403,38
Taliaferro,Election Day,314,State School Superintendent,287,27
Taliaferro,Provisional,4,State School Superintendent,4,0
Tattnall,Absentee by Mail,392,State School Superintendent,387,5
Tattnall,Advance in Person,3539,State School Superintendent,3432,107
Tattnall,Election Day,2708,State School Superintendent,2628,80
Tattnall,Provisional,8,State School Superintendent,8,0
Taylor,Absentee by Mail,243,State School Superintendent,239,4
Taylor,Advance in Person,1843,State School Superintendent,1814,29
Taylor,Election Day,1179,State School Superintendent,1138,41
Taylor,Provisional,29,State School Superintendent,28,1
Telfair,Absentee by Mail,331,State School Superintendent,329,2
Telfair,Advance in Person,1676,State School Superintendent,1619,57
Telfair,Election Day,1624,State School Superintendent,1565,59
Telfair,Provisional,1,State School Superintendent,1,0
Terrell,Absentee by Mail,327,State School Superintendent,324,3
Terrell,Advance in Person,1612,State School Superintendent,1575,37
Terrell,Election Day,1991,State School Superintendent,1927,64
Terrell,Provisional,9,State School Superintendent,9,0
Thomas,Absentee by Mail,991,State School Superintendent,973,18
Thomas,Advance in Person,8376,State School Superintendent,8228,148
Thomas,Election Day,7874,State School Superintendent,7708,166
Thomas,Provisional,3,State School Superintendent,3,0
Tift,Absentee by Mail,561,State School Superintendent,549,12
Tift,Advance in Person,7646,State School Superintendent,7497,149
Tift,Election Day,5462,State School Superintendent,5345,117
Tift,Provisional,4,State School Superintendent,3,1
Toombs,Absentee by Mail,681,State School Superintendent,664,17
Toombs,Advance in Person,4860,State School Superintendent,4747,113
Toombs,Election Day,3310,State School Superintendent,3220,90
Toombs,Provisional,9,State School Superintendent,9,0
Towns,Absentee by Mail,284,State School Superintendent,276,8
Towns,Advance in Person,4009,State School Superintendent,3917,92
Towns,Election Day,1839,State School Superintendent,1798,41
Towns,Provisional,0,State School Superintendent,0,0
Treutlen,Absentee by Mail,146,State School Superintendent,136,10
Treutlen,Advance in Person,1659,State School Superintendent,1586,73
Treutlen,Election Day,805,State School Superintendent,765,40
Treutlen,Provisional,4,State School Superintendent,4,0
Troup,Absentee by Mail,1264,State School Superintendent,1233,31
Troup,Advance in Person,11226,State School Superintendent,11070,156
Troup,Election Day,11173,State School Superintendent,10940,233
Troup,Provisional,250,State School Superintendent,242,8
Turner,Absentee by Mail,148,State School Superintendent,147,1
Turner,Advance in Person,1922,State School Superintendent,1869,53
Turner,Election Day,1199,State School Superintendent,1165,34
Turner,Provisional,5,State School Superintendent,5,0
Twiggs,Absentee by Mail,275,State School Superintendent,268,7
Twiggs,Advance in Person,1531,State School Superintendent,1492,39
Twiggs,Election Day,1981,State School Superintendent,1893,88
Twiggs,Provisional,5,State School Superintendent,5,0
Union,Absentee by Mail,482,State School Superintendent,469,13
Union,Advance in Person,6626,State School Superintendent,6518,108
Union,Election Day,4755,State School Superintendent,4629,126
Union,Provisional,2,State School Superintendent,2,0
Upson,Absentee by Mail,602,State School Superintendent,591,11
Upson,Advance in Person,6729,State School Superintendent,6589,140
Upson,Election Day,3227,State School Superintendent,3153,74
Upson,Provisional,10,State School Superintendent,9,1
Walker,Absentee by Mail,813,State School Superintendent,797,16
Walker,Advance in Person,11133,State School Superintendent,10960,173
Walker,Election Day,9505,State School Superintendent,9298,207
Walker,Provisional,39,State School Superintendent,38,1
Walton,Absentee by Mail,1769,State School Superintendent,1745,24
Walton,Advance in Person,14370,State School Superintendent,14135,235
Walton,Election Day,22496,State School Superintendent,22095,401
Walton,Provisional,51,State School Superintendent,51,0
Ware,Absentee by Mail,627,State School Superintendent,615,12
Ware,Advance in Person,5460,State School Superintendent,5407,53
Ware,Election Day,4917,State School Superintendent,4821,96
Ware,Provisional,12,State School Superintendent,12,0
Warren,Absentee by Mail,187,State School Superintendent,185,2
Warren,Advance in Person,1267,State School Superintendent,1223,44
Warren,Election Day,806,State School Superintendent,779,27
Warren,Provisional,1,State School Superintendent,1,0
Washington,Absentee by Mail,727,State School Superintendent,702,25
Washington,Advance in Person,3907,State School Superintendent,3774,133
Washington,Election Day,3525,State School Superintendent,3358,167
Washington,Provisional,10,State School Superintendent,10,0
Wayne,Absentee by Mail,501,State School Superintendent,498,3
Wayne,Advance in Person,5868,State School Superintendent,5751,117
Wayne,Election Day,3753,State School Superintendent,3656,97
Wayne,Provisional,10,State School Superintendent,8,2
Webster,Absentee by Mail,152,State School Superintendent,147,5
Webster,Advance in Person,544,State School Superintendent,529,15
Webster,Election Day,404,State School Superintendent,392,12
Webster,Provisional,0,State School Superintendent,0,0
Wheeler,Absentee by Mail,115,State School Superintendent,115,0
Wheeler,Advance in Person,974,State School Superintendent,955,19
Wheeler,Election Day,838,State School Superintendent,814,24
Wheeler,Provisional,4,State School Superintendent,3,1
White,Absentee by Mail,537,State School Superintendent,529,8
White,Advance in Person,5408,State School Superintendent,5308,100
White,Election Day,5489,State School Superintendent,5394,95
White,Provisional,6,State School Superintendent,6,0
Whitfield,Absentee by Mail,1017,State School Superintendent,991,26
Whitfield,Advance in Person,9610,State School Superintendent,9419,191
Whitfield,Election Day,16675,State School Superintendent,16257,418
Whitfield,Provisional,25,State School Superintendent,24,1
Wilcox,Absentee by Mail,205,State School Superintendent,199,6
Wilcox,Advance in Person,1202,State School Superintendent,1172,30
Wilcox,Election Day,1408,State School Superintendent,1365,43
Wilcox,Provisional,0,State School Superintendent,0,0
Wilkes,Absentee by Mail,301,State School Superintendent,288,13
Wilkes,Advance in Person,2075,State School Superintendent,2014,61
Wilkes,Election Day,1995,State School Superintendent,1936,59
Wilkes,Provisional,6,State School Superintendent,5,1
Wilkinson,Absentee by Mail,270,State School Superintendent,263,7
Wilkinson,Advance in Person,1567,State School Superintendent,1517,50
Wilkinson,Election Day,2427,State School Superintendent,2341,86
Wilkinson,Provisional,1,State School Superintendent,1,0
Worth,Absentee by Mail,305,State School Superintendent,299,6
Worth,Advance in Person,3108,State School Superintendent,3061,47
Worth,Election Day,4418,State School Superintendent,4312,106
Worth,Provisional,15,State School Superintendent,15,0
Appling,Absentee by Mail,530,Commissioner Of Labor,516,14
Appling,Advance in Person,3298,Commissioner Of Labor,3198,100
Appling,Election Day,2978,Commissioner Of Labor,2875,103
Appling,Provisional,3,Commissioner Of Labor,3,0
Atkinson,Absentee by Mail,88,Commissioner Of Labor,87,1
Atkinson,Advance in Person,1285,Commissioner Of Labor,1227,58
Atkinson,Election Day,1147,Commissioner Of Labor,1088,59
Atkinson,Provisional,2,Commissioner Of Labor,2,0
Bacon,Absentee by Mail,174,Commissioner Of Labor,172,2
Bacon,Advance in Person,2828,Commissioner Of Labor,2761,67
Bacon,Election Day,827,Commissioner Of Labor,782,45
Bacon,Provisional,1,Commissioner Of Labor,1,0
Baker,Absentee by Mail,141,Commissioner Of Labor,131,10
Baker,Advance in Person,485,Commissioner Of Labor,465,20
Baker,Election Day,665,Commissioner Of Labor,633,32
Baker,Provisional,2,Commissioner Of Labor,2,0
Baldwin,Absentee by Mail,1158,Commissioner Of Labor,1129,29
Baldwin,Advance in Person,8295,Commissioner Of Labor,8066,229
Baldwin,Election Day,6180,Commissioner Of Labor,5983,197
Baldwin,Provisional,3,Commissioner Of Labor,3,0
Banks,Absentee by Mail,223,Commissioner Of Labor,218,5
Banks,Advance in Person,2771,Commissioner Of Labor,2715,56
Banks,Election Day,3858,Commissioner Of Labor,3778,80
Banks,Provisional,1,Commissioner Of Labor,1,0
Barrow,Absentee by Mail,1263,Commissioner Of Labor,1227,36
Barrow,Advance in Person,12223,Commissioner Of Labor,12033,190
Barrow,Election Day,13912,Commissioner Of Labor,13602,310
Barrow,Provisional,7,Commissioner Of Labor,7,0
Bartow,Absentee by Mail,1568,Commissioner Of Labor,1551,17
Bartow,Advance in Person,16175,Commissioner Of Labor,15896,279
Bartow,Election Day,19584,Commissioner Of Labor,19154,430
Bartow,Provisional,32,Commissioner Of Labor,32,0
Ben Hill,Absentee by Mail,320,Commissioner Of Labor,313,7
Ben Hill,Advance in Person,3605,Commissioner Of Labor,3541,64
Ben Hill,Election Day,1608,Commissioner Of Labor,1563,45
Ben Hill,Provisional,14,Commissioner Of Labor,13,1
Berrien,Absentee by Mail,322,Commissioner Of Labor,317,5
Berrien,Advance in Person,3153,Commissioner Of Labor,3084,69
Berrien,Election Day,2772,Commissioner Of Labor,2689,83
Berrien,Provisional,5,Commissioner Of Labor,4,1
Bibb,Absentee by Mail,4461,Commissioner Of Labor,4361,100
Bibb,Advance in Person,26183,Commissioner Of Labor,25590,593
Bibb,Election Day,29816,Commissioner Of Labor,29054,762
Bibb,Provisional,232,Commissioner Of Labor,227,5
Bleckley,Absentee by Mail,257,Commissioner Of Labor,250,7
Bleckley,Advance in Person,2805,Commissioner Of Labor,2721,84
Bleckley,Election Day,1793,Commissioner Of Labor,1721,72
Bleckley,Provisional,5,Commissioner Of Labor,5,0
Brantley,Absentee by Mail,188,Commissioner Of Labor,183,5
Brantley,Advance in Person,2868,Commissioner Of Labor,2819,49
Brantley,Election Day,2633,Commissioner Of Labor,2551,82
Brantley,Provisional,5,Commissioner Of Labor,5,0
Brooks,Absentee by Mail,465,Commissioner Of Labor,450,15
Brooks,Advance in Person,2417,Commissioner Of Labor,2359,58
Brooks,Election Day,2814,Commissioner Of Labor,2746,68
Brooks,Provisional,27,Commissioner Of Labor,27,0
Bryan,Absentee by Mail,582,Commissioner Of Labor,570,12
Bryan,Advance in Person,8342,Commissioner Of Labor,8197,145
Bryan,Election Day,6046,Commissioner Of Labor,5918,128
Bryan,Provisional,15,Commissioner Of Labor,15,0
Bulloch,Absentee by Mail,1076,Commissioner Of Labor,1050,26
Bulloch,Advance in Person,11170,Commissioner Of Labor,10911,259
Bulloch,Election Day,11297,Commissioner Of Labor,11002,295
Bulloch,Provisional,140,Commissioner Of Labor,132,8
Burke,Absentee by Mail,968,Commissioner Of Labor,950,18
Burke,Advance in Person,3199,Commissioner Of Labor,3126,73
Burke,Election Day,4552,Commissioner Of Labor,4428,124
Burke,Provisional,2,Commissioner Of Labor,2,0
Butts,Absentee by Mail,380,Commissioner Of Labor,373,7
Butts,Advance in Person,6277,Commissioner Of Labor,6155,122
Butts,Election Day,2206,Commissioner Of Labor,2162,44
Butts,Provisional,0,Commissioner Of Labor,0,0
Calhoun,Absentee by Mail,185,Commissioner Of Labor,180,5
Calhoun,Advance in Person,607,Commissioner Of Labor,592,15
Calhoun,Election Day,1107,Commissioner Of Labor,1077,30
Calhoun,Provisional,0,Commissioner Of Labor,0,0
Camden,Absentee by Mail,1193,Commissioner Of Labor,1171,22
Camden,Advance in Person,8085,Commissioner Of Labor,7955,130
Camden,Election Day,7775,Commissioner Of Labor,7561,214
Camden,Provisional,8,Commissioner Of Labor,8,0
Candler,Absentee by Mail,120,Commissioner Of Labor,116,4
Candler,Advance in Person,2335,Commissioner Of Labor,2283,52
Candler,Election Day,1083,Commissioner Of Labor,1051,32
Candler,Provisional,1,Commissioner Of Labor,1,0
Carroll,Absentee by Mail,1518,Commissioner Of Labor,1494,24
Carroll,Advance in Person,20100,Commissioner Of Labor,19786,314
Carroll,Election Day,20121,Commissioner Of Labor,19688,433
Carroll,Provisional,104,Commissioner Of Labor,101,3
Catoosa,Absentee by Mail,540,Commissioner Of Labor,529,11
Catoosa,Advance in Person,13673,Commissioner Of Labor,13415,258
Catoosa,Election Day,9512,Commissioner Of Labor,9303,209
Catoosa,Provisional,33,Commissioner Of Labor,33,0
Charlton,Absentee by Mail,163,Commissioner Of Labor,159,4
Charlton,Advance in Person,1549,Commissioner Of Labor,1521,28
Charlton,Election Day,1657,Commissioner Of Labor,1599,58
Charlton,Provisional,8,Commissioner Of Labor,8,0
Chatham,Absentee by Mail,6177,Commissioner Of Labor,6033,144
Chatham,Advance in Person,32338,Commissioner Of Labor,31723,615
Chatham,Election Day,64823,Commissioner Of Labor,63091,1732
Chatham,Provisional,205,Commissioner Of Labor,201,4
Chattahoochee,Absentee by Mail,35,Commissioner Of Labor,35,0
Chattahoochee,Advance in Person,493,Commissioner Of Labor,474,19
Chattahoochee,Election Day,574,Commissioner Of Labor,552,22
Chattahoochee,Provisional,3,Commissioner Of Labor,3,0
Chattooga,Absentee by Mail,225,Commissioner Of Labor,223,2
Chattooga,Advance in Person,3452,Commissioner Of Labor,3354,98
Chattooga,Election Day,3750,Commissioner Of Labor,3643,107
Chattooga,Provisional,7,Commissioner Of Labor,7,0
Cherokee,Absentee by Mail,5312,Commissioner Of Labor,5196,116
Cherokee,Advance in Person,48565,Commissioner Of Labor,47783,782
Cherokee,Election Day,52422,Commissioner Of Labor,51029,1393
Cherokee,Provisional,112,Commissioner Of Labor,105,7
Clarke,Absentee by Mail,3022,Commissioner Of Labor,2937,85
Clarke,Advance in Person,19957,Commissioner Of Labor,19537,420
Clarke,Election Day,20282,Commissioner Of Labor,19570,712
Clarke,Provisional,41,Commissioner Of Labor,40,1
Clay,Absentee by Mail,143,Commissioner Of Labor,132,11
Clay,Advance in Person,579,Commissioner Of Labor,565,14
Clay,Election Day,464,Commissioner Of Labor,448,16
Clay,Provisional,0,Commissioner Of Labor,0,0
Clayton,Absentee by Mail,5847,Commissioner Of Labor,5712,135
Clayton,Advance in Person,47671,Commissioner Of Labor,46825,846
Clayton,Election Day,38322,Commissioner Of Labor,37515,807
Clayton,Provisional,372,Commissioner Of Labor,354,18
Clinch,Absentee by Mail,109,Commissioner Of Labor,105,4
Clinch,Advance in Person,1236,Commissioner Of Labor,1188,48
Clinch,Election Day,909,Commissioner Of Labor,875,34
Clinch,Provisional,4,Commissioner Of Labor,4,0
Cobb,Absentee by Mail,25901,Commissioner Of Labor,25296,605
Cobb,Advance in Person,111554,Commissioner Of Labor,109848,1706
Cobb,Election Day,172926,Commissioner Of Labor,168923,4003
Cobb,Provisional,1433,Commissioner Of Labor,1373,60
Coffee,Absentee by Mail,395,Commissioner Of Labor,385,10
Coffee,Advance in Person,7664,Commissioner Of Labor,7442,222
Coffee,Election Day,4536,Commissioner Of Labor,4376,160
Coffee,Provisional,20,Commissioner Of Labor,19,1
Colquitt,Absentee by Mail,514,Commissioner Of Labor,502,12
Colquitt,Advance in Person,6071,Commissioner Of Labor,5908,163
Colquitt,Election Day,6368,Commissioner Of Labor,6149,219
Colquitt,Provisional,10,Commissioner Of Labor,9,1
Columbia,Absentee by Mail,2936,Commissioner Of Labor,2857,79
Columbia,Advance in Person,29686,Commissioner Of Labor,29311,375
Columbia,Election Day,28969,Commissioner Of Labor,28364,605
Columbia,Provisional,43,Commissioner Of Labor,43,0
Cook,Absentee by Mail,244,Commissioner Of Labor,242,2
Cook,Advance in Person,3069,Commissioner Of Labor,3006,63
Cook,Election Day,2490,Commissioner Of Labor,2435,55
Cook,Provisional,0,Commissioner Of Labor,0,0
Coweta,Absentee by Mail,2812,Commissioner Of Labor,2760,52
Coweta,Advance in Person,25641,Commissioner Of Labor,25238,403
Coweta,Election Day,29603,Commissioner Of Labor,28962,641
Coweta,Provisional,15,Commissioner Of Labor,15,0
Crawford,Absentee by Mail,234,Commissioner Of Labor,226,8
Crawford,Advance in Person,2567,Commissioner Of Labor,2486,81
Crawford,Election Day,2130,Commissioner Of Labor,2087,43
Crawford,Provisional,3,Commissioner Of Labor,3,0
Crisp,Absentee by Mail,363,Commissioner Of Labor,353,10
Crisp,Advance in Person,4191,Commissioner Of Labor,4071,120
Crisp,Election Day,2470,Commissioner Of Labor,2353,117
Crisp,Provisional,26,Commissioner Of Labor,22,4
Dade,Absentee by Mail,129,Commissioner Of Labor,119,10
Dade,Advance in Person,2561,Commissioner Of Labor,2475,86
Dade,Election Day,2760,Commissioner Of Labor,2661,99
Dade,Provisional,12,Commissioner Of Labor,12,0
Dawson,Absentee by Mail,439,Commissioner Of Labor,432,7
Dawson,Advance in Person,7020,Commissioner Of Labor,6894,126
Dawson,Election Day,4111,Commissioner Of Labor,4018,93
Dawson,Provisional,11,Commissioner Of Labor,10,1
DeKalb,Absentee by Mail,19672,Commissioner Of Labor,19013,659
DeKalb,Advance in Person,150814,Commissioner Of Labor,147602,3212
DeKalb,Election Day,140482,Commissioner Of Labor,136235,4247
DeKalb,Provisional,1773,Commissioner Of Labor,1690,83
Decatur,Absentee by Mail,548,Commissioner Of Labor,532,16
Decatur,Advance in Person,4260,Commissioner Of Labor,4167,93
Decatur,Election Day,4235,Commissioner Of Labor,4117,118
Decatur,Provisional,103,Commissioner Of Labor,95,8
Dodge,Absentee by Mail,448,Commissioner Of Labor,432,16
Dodge,Advance in Person,3411,Commissioner Of Labor,3274,137
Dodge,Election Day,3192,Commissioner Of Labor,3046,146
Dodge,Provisional,10,Commissioner Of Labor,10,0
Dooly,Absentee by Mail,196,Commissioner Of Labor,190,6
Dooly,Advance in Person,1889,Commissioner Of Labor,1806,83
Dooly,Election Day,1708,Commissioner Of Labor,1641,67
Dooly,Provisional,2,Commissioner Of Labor,1,1
Dougherty,Absentee by Mail,1944,Commissioner Of Labor,1908,36
Dougherty,Advance in Person,11332,Commissioner Of Labor,11137,195
Dougherty,Election Day,18021,Commissioner Of Labor,17578,443
Dougherty,Provisional,128,Commissioner Of Labor,121,7
Douglas,Absentee by Mail,3233,Commissioner Of Labor,3185,48
Douglas,Advance in Person,30219,Commissioner Of Labor,29809,410
Douglas,Election Day,21745,Commissioner Of Labor,21351,394
Douglas,Provisional,58,Commissioner Of Labor,58,0
Early,Absentee by Mail,473,Commissioner Of Labor,460,13
Early,Advance in Person,1569,Commissioner Of Labor,1547,22
Early,Election Day,2089,Commissioner Of Labor,2038,51
Early,Provisional,4,Commissioner Of Labor,4,0
Echols,Absentee by Mail,35,Commissioner Of Labor,35,0
Echols,Advance in Person,767,Commissioner Of Labor,748,19
Echols,Election Day,341,Commissioner Of Labor,332,9
Echols,Provisional,0,Commissioner Of Labor,0,0
Effingham,Absentee by Mail,750,Commissioner Of Labor,740,10
Effingham,Advance in Person,10717,Commissioner Of Labor,10548,169
Effingham,Election Day,11898,Commissioner Of Labor,11663,235
Effingham,Provisional,6,Commissioner Of Labor,6,0
Elbert,Absentee by Mail,563,Commissioner Of Labor,558,5
Elbert,Advance in Person,3722,Commissioner Of Labor,3625,97
Elbert,Election Day,3034,Commissioner Of Labor,2948,86
Elbert,Provisional,69,Commissioner Of Labor,65,4
Emanuel,Absentee by Mail,390,Commissioner Of Labor,380,10
Emanuel,Advance in Person,3424,Commissioner Of Labor,3331,93
Emanuel,Election Day,3896,Commissioner Of Labor,3730,166
Emanuel,Provisional,6,Commissioner Of Labor,6,0
Evans,Absentee by Mail,199,Commissioner Of Labor,193,6
Evans,Advance in Person,2162,Commissioner Of Labor,2090,72
Evans,Election Day,1086,Commissioner Of Labor,1046,40
Evans,Provisional,0,Commissioner Of Labor,0,0
Fannin,Absentee by Mail,658,Commissioner Of Labor,639,19
Fannin,Advance in Person,5341,Commissioner Of Labor,5230,111
Fannin,Election Day,5204,Commissioner Of Labor,5047,157
Fannin,Provisional,16,Commissioner Of Labor,15,1
Fayette,Absentee by Mail,2647,Commissioner Of Labor,2577,70
Fayette,Advance in Person,31073,Commissioner Of Labor,30555,518
Fayette,Election Day,24242,Commissioner Of Labor,23607,635
Fayette,Provisional,36,Commissioner Of Labor,34,2
Floyd,Absentee by Mail,1260,Commissioner Of Labor,1225,35
Floyd,Advance in Person,13688,Commissioner Of Labor,13445,243
Floyd,Election Day,15277,Commissioner Of Labor,14883,394
Floyd,Provisional,113,Commissioner Of Labor,109,4
Forsyth,Absentee by Mail,4428,Commissioner Of Labor,4321,107
Forsyth,Advance in Person,52559,Commissioner Of Labor,51683,876
Forsyth,Election Day,36252,Commissioner Of Labor,35324,928
Forsyth,Provisional,59,Commissioner Of Labor,58,1
Franklin,Absentee by Mail,388,Commissioner Of Labor,384,4
Franklin,Advance in Person,3502,Commissioner Of Labor,3463,39
Franklin,Election Day,4259,Commissioner Of Labor,4155,104
Franklin,Provisional,0,Commissioner Of Labor,0,0
Fulton,Absentee by Mail,17842,Commissioner Of Labor,17165,677
Fulton,Advance in Person,224522,Commissioner Of Labor,219335,5187
Fulton,Election Day,179442,Commissioner Of Labor,173732,5710
Fulton,Provisional,1982,Commissioner Of Labor,1875,107
Gilmer,Absentee by Mail,559,Commissioner Of Labor,555,4
Gilmer,Advance in Person,6295,Commissioner Of Labor,6153,142
Gilmer,Election Day,5617,Commissioner Of Labor,5446,171
Gilmer,Provisional,39,Commissioner Of Labor,36,3
Glascock,Absentee by Mail,81,Commissioner Of Labor,78,3
Glascock,Advance in Person,652,Commissioner Of Labor,629,23
Glascock,Election Day,567,Commissioner Of Labor,527,40
Glascock,Provisional,1,Commissioner Of Labor,1,0
Glynn,Absentee by Mail,1812,Commissioner Of Labor,1790,22
Glynn,Advance in Person,17510,Commissioner Of Labor,17129,381
Glynn,Election Day,13179,Commissioner Of Labor,12832,347
Glynn,Provisional,147,Commissioner Of Labor,140,7
Gordon,Absentee by Mail,547,Commissioner Of Labor,529,18
Gordon,Advance in Person,8119,Commissioner Of Labor,7912,207
Gordon,Election Day,9106,Commissioner Of Labor,8846,260
Gordon,Provisional,32,Commissioner Of Labor,31,1
Grady,Absentee by Mail,400,Commissioner Of Labor,388,12
Grady,Advance in Person,3857,Commissioner Of Labor,3805,52
Grady,Election Day,4099,Commissioner Of Labor,3999,100
Grady,Provisional,14,Commissioner Of Labor,14,0
Greene,Absentee by Mail,623,Commissioner Of Labor,607,16
Greene,Advance in Person,5593,Commissioner Of Labor,5518,75
Greene,Election Day,2773,Commissioner Of Labor,2697,76
Greene,Provisional,6,Commissioner Of Labor,6,0
Gwinnett,Absentee by Mail,20397,Commissioner Of Labor,20077,320
Gwinnett,Advance in Person,137166,Commissioner Of Labor,135140,2026
Gwinnett,Election Day,155146,Commissioner Of Labor,151818,3328
Gwinnett,Provisional,2209,Commissioner Of Labor,2163,46
Habersham,Absentee by Mail,853,Commissioner Of Labor,837,16
Habersham,Advance in Person,10023,Commissioner Of Labor,9802,221
Habersham,Election Day,4619,Commissioner Of Labor,4487,132
Habersham,Provisional,5,Commissioner Of Labor,5,0
Hall,Absentee by Mail,3493,Commissioner Of Labor,3416,77
Hall,Advance in Person,24348,Commissioner Of Labor,23913,435
Hall,Election Day,39441,Commissioner Of Labor,38543,898
Hall,Provisional,124,Commissioner Of Labor,117,7
Hancock,Absentee by Mail,490,Commissioner Of Labor,473,17
Hancock,Advance in Person,1531,Commissioner Of Labor,1465,66
Hancock,Election Day,1518,Commissioner Of Labor,1430,88
Hancock,Provisional,9,Commissioner Of Labor,8,1
Haralson,Absentee by Mail,393,Commissioner Of Labor,390,3
Haralson,Advance in Person,4202,Commissioner Of Labor,4128,74
Haralson,Election Day,5990,Commissioner Of Labor,5886,104
Haralson,Provisional,0,Commissioner Of Labor,0,0
Harris,Absentee by Mail,729,Commissioner Of Labor,711,18
Harris,Advance in Person,7251,Commissioner Of Labor,7147,104
Harris,Election Day,7992,Commissioner Of Labor,7805,187
Harris,Provisional,14,Commissioner Of Labor,14,0
Hart,Absentee by Mail,440,Commissioner Of Labor,429,11
Hart,Advance in Person,5220,Commissioner Of Labor,5063,157
Hart,Election Day,3958,Commissioner Of Labor,3832,126
Hart,Provisional,4,Commissioner Of Labor,4,0
Heard,Absentee by Mail,278,Commissioner Of Labor,270,8
Heard,Advance in Person,1427,Commissioner Of Labor,1392,35
Heard,Election Day,2346,Commissioner Of Labor,2295,51
Heard,Provisional,4,Commissioner Of Labor,4,0
Henry,Absentee by Mail,4997,Commissioner Of Labor,4886,111
Henry,Advance in Person,58658,Commissioner Of Labor,57788,870
Henry,Election Day,34710,Commissioner Of Labor,34029,681
Henry,Provisional,193,Commissioner Of Labor,186,7
Houston,Absentee by Mail,3190,Commissioner Of Labor,3120,70
Houston,Advance in Person,34816,Commissioner Of Labor,34311,505
Houston,Election Day,21152,Commissioner Of Labor,20725,427
Houston,Provisional,74,Commissioner Of Labor,69,5
Irwin,Absentee by Mail,133,Commissioner Of Labor,130,3
Irwin,Advance in Person,2048,Commissioner Of Labor,1986,62
Irwin,Election Day,1375,Commissioner Of Labor,1346,29
Irwin,Provisional,8,Commissioner Of Labor,8,0
Jackson,Absentee by Mail,1019,Commissioner Of Labor,1004,15
Jackson,Advance in Person,14919,Commissioner Of Labor,14703,216
Jackson,Election Day,10951,Commissioner Of Labor,10719,232
Jackson,Provisional,10,Commissioner Of Labor,9,1
Jasper,Absentee by Mail,421,Commissioner Of Labor,410,11
Jasper,Advance in Person,2981,Commissioner Of Labor,2917,64
Jasper,Election Day,2505,Commissioner Of Labor,2447,58
Jasper,Provisional,38,Commissioner Of Labor,35,3
Jeff Davis,Absentee by Mail,229,Commissioner Of Labor,220,9
Jeff Davis,Advance in Person,2680,Commissioner Of Labor,2592,88
Jeff Davis,Election Day,1906,Commissioner Of Labor,1821,85
Jeff Davis,Provisional,0,Commissioner Of Labor,0,0
Jefferson,Absentee by Mail,607,Commissioner Of Labor,587,20
Jefferson,Advance in Person,2803,Commissioner Of Labor,2695,108
Jefferson,Election Day,3346,Commissioner Of Labor,3216,130
Jefferson,Provisional,11,Commissioner Of Labor,10,1
Jenkins,Absentee by Mail,188,Commissioner Of Labor,181,7
Jenkins,Advance in Person,1557,Commissioner Of Labor,1513,44
Jenkins,Election Day,1111,Commissioner Of Labor,1078,33
Jenkins,Provisional,16,Commissioner Of Labor,16,0
Johnson,Absentee by Mail,236,Commissioner Of Labor,222,14
Johnson,Advance in Person,1970,Commissioner Of Labor,1912,58
Johnson,Election Day,1277,Commissioner Of Labor,1211,66
Johnson,Provisional,0,Commissioner Of Labor,0,0
Jones,Absentee by Mail,784,Commissioner Of Labor,762,22
Jones,Advance in Person,6968,Commissioner Of Labor,6831,137
Jones,Election Day,4680,Commissioner Of Labor,4565,115
Jones,Provisional,9,Commissioner Of Labor,9,0
Lamar,Absentee by Mail,404,Commissioner Of Labor,396,8
Lamar,Advance in Person,3820,Commissioner Of Labor,3742,78
Lamar,Election Day,3122,Commissioner Of Labor,3054,68
Lamar,Provisional,11,Commissioner Of Labor,11,0
Lanier,Absentee by Mail,108,Commissioner Of Labor,105,3
Lanier,Advance in Person,1661,Commissioner Of Labor,1609,52
Lanier,Election Day,910,Commissioner Of Labor,864,46
Lanier,Provisional,2,Commissioner Of Labor,2,0
Laurens,Absentee by Mail,1286,Commissioner Of Labor,1247,39
Laurens,Advance in Person,8485,Commissioner Of Labor,8268,217
Laurens,Election Day,9168,Commissioner Of Labor,8903,265
Laurens,Provisional,13,Commissioner Of Labor,12,1
Lee,Absentee by Mail,480,Commissioner Of Labor,471,9
Lee,Advance in Person,5681,Commissioner Of Labor,5588,93
Lee,Election Day,7388,Commissioner Of Labor,7263,125
Lee,Provisional,6,Commissioner Of Labor,6,0
Liberty,Absentee by Mail,950,Commissioner Of Labor,931,19
Liberty,Advance in Person,8143,Commissioner Of Labor,8022,121
Liberty,Election Day,6265,Commissioner Of Labor,6147,118
Liberty,Provisional,10,Commissioner Of Labor,9,1
Lincoln,Absentee by Mail,350,Commissioner Of Labor,345,5
Lincoln,Advance in Person,1937,Commissioner Of Labor,1897,40
Lincoln,Election Day,1680,Commissioner Of Labor,1623,57
Lincoln,Provisional,2,Commissioner Of Labor,2,0
Long,Absentee by Mail,169,Commissioner Of Labor,166,3
Long,Advance in Person,1971,Commissioner Of Labor,1912,59
Long,Election Day,1848,Commissioner Of Labor,1790,58
Long,Provisional,10,Commissioner Of Labor,10,0
Lowndes,Absentee by Mail,1890,Commissioner Of Labor,1845,45
Lowndes,Advance in Person,21238,Commissioner Of Labor,20928,310
Lowndes,Election Day,12084,Commissioner Of Labor,11803,281
Lowndes,Provisional,541,Commissioner Of Labor,516,25
Lumpkin,Absentee by Mail,467,Commissioner Of Labor,455,12
Lumpkin,Advance in Person,7377,Commissioner Of Labor,7247,130
Lumpkin,Election Day,3707,Commissioner Of Labor,3597,110
Lumpkin,Provisional,7,Commissioner Of Labor,7,0
Macon,Absentee by Mail,331,Commissioner Of Labor,319,12
Macon,Advance in Person,2251,Commissioner Of Labor,2145,106
Macon,Election Day,1635,Commissioner Of Labor,1561,74
Macon,Provisional,0,Commissioner Of Labor,0,0
Madison,Absentee by Mail,527,Commissioner Of Labor,520,7
Madison,Advance in Person,5242,Commissioner Of Labor,5123,119
Madison,Election Day,5928,Commissioner Of Labor,5769,159
Madison,Provisional,2,Commissioner Of Labor,2,0
Marion,Absentee by Mail,241,Commissioner Of Labor,240,1
Marion,Advance in Person,1222,Commissioner Of Labor,1182,40
Marion,Election Day,1467,Commissioner Of Labor,1424,43
Marion,Provisional,1,Commissioner Of Labor,1,0
McDuffie,Absentee by Mail,868,Commissioner Of Labor,847,21
McDuffie,Advance in Person,5045,Commissioner Of Labor,4954,91
McDuffie,Election Day,2879,Commissioner Of Labor,2820,59
McDuffie,Provisional,0,Commissioner Of Labor,0,0
McIntosh,Absentee by Mail,440,Commissioner Of Labor,427,13
McIntosh,Advance in Person,2945,Commissioner Of Labor,2870,75
McIntosh,Election Day,2023,Commissioner Of Labor,1959,64
McIntosh,Provisional,0,Commissioner Of Labor,0,0
Meriwether,Absentee by Mail,483,Commissioner Of Labor,470,13
Meriwether,Advance in Person,2831,Commissioner Of Labor,2774,57
Meriwether,Election Day,5325,Commissioner Of Labor,5186,139
Meriwether,Provisional,11,Commissioner Of Labor,10,1
Miller,Absentee by Mail,132,Commissioner Of Labor,126,6
Miller,Advance in Person,1029,Commissioner Of Labor,986,43
Miller,Election Day,1152,Commissioner Of Labor,1094,58
Miller,Provisional,2,Commissioner Of Labor,2,0
Mitchell,Absentee by Mail,564,Commissioner Of Labor,551,13
Mitchell,Advance in Person,3343,Commissioner Of Labor,3282,61
Mitchell,Election Day,3539,Commissioner Of Labor,3457,82
Mitchell,Provisional,9,Commissioner Of Labor,9,0
Monroe,Absentee by Mail,696,Commissioner Of Labor,686,10
Monroe,Advance in Person,6311,Commissioner Of Labor,6160,151
Monroe,Election Day,5925,Commissioner Of Labor,5760,165
Monroe,Provisional,10,Commissioner Of Labor,10,0
Montgomery,Absentee by Mail,211,Commissioner Of Labor,205,6
Montgomery,Advance in Person,1416,Commissioner Of Labor,1364,52
Montgomery,Election Day,1901,Commissioner Of Labor,1831,70
Montgomery,Provisional,0,Commissioner Of Labor,0,0
Morgan,Absentee by Mail,410,Commissioner Of Labor,394,16
Morgan,Advance in Person,5406,Commissioner Of Labor,5290,116
Morgan,Election Day,3738,Commissioner Of Labor,3629,109
Morgan,Provisional,4,Commissioner Of Labor,4,0
Murray,Absentee by Mail,265,Commissioner Of Labor,250,15
Murray,Advance in Person,5111,Commissioner Of Labor,4980,131
Murray,Election Day,5715,Commissioner Of Labor,5547,168
Murray,Provisional,0,Commissioner Of Labor,0,0
Muscogee,Absentee by Mail,4422,Commissioner Of Labor,4337,85
Muscogee,Advance in Person,27700,Commissioner Of Labor,27188,512
Muscogee,Election Day,31019,Commissioner Of Labor,30322,697
Muscogee,Provisional,131,Commissioner Of Labor,125,6
Newton,Absentee by Mail,2735,Commissioner Of Labor,2668,67
Newton,Advance in Person,19236,Commissioner Of Labor,18853,383
Newton,Election Day,21158,Commissioner Of Labor,20738,420
Newton,Provisional,12,Commissioner Of Labor,11,1
Oconee,Absentee by Mail,931,Commissioner Of Labor,908,23
Oconee,Advance in Person,11688,Commissioner Of Labor,11445,243
Oconee,Election Day,8114,Commissioner Of Labor,7874,240
Oconee,Provisional,11,Commissioner Of Labor,11,0
Oglethorpe,Absentee by Mail,409,Commissioner Of Labor,401,8
Oglethorpe,Advance in Person,3417,Commissioner Of Labor,3313,104
Oglethorpe,Election Day,2658,Commissioner Of Labor,2566,92
Oglethorpe,Provisional,1,Commissioner Of Labor,1,0
Paulding,Absentee by Mail,3307,Commissioner Of Labor,3234,73
Paulding,Advance in Person,32842,Commissioner Of Labor,32290,552
Paulding,Election Day,25073,Commissioner Of Labor,24566,507
Paulding,Provisional,83,Commissioner Of Labor,80,3
Peach,Absentee by Mail,445,Commissioner Of Labor,433,12
Peach,Advance in Person,6720,Commissioner Of Labor,6585,135
Peach,Election Day,3190,Commissioner Of Labor,3120,70
Peach,Provisional,90,Commissioner Of Labor,86,4
Pickens,Absentee by Mail,222,Commissioner Of Labor,215,7
Pickens,Advance in Person,7121,Commissioner Of Labor,6950,171
Pickens,Election Day,6019,Commissioner Of Labor,5843,176
Pickens,Provisional,0,Commissioner Of Labor,0,0
Pierce,Absentee by Mail,327,Commissioner Of Labor,324,3
Pierce,Advance in Person,4598,Commissioner Of Labor,4528,70
Pierce,Election Day,1958,Commissioner Of Labor,1924,34
Pierce,Provisional,1,Commissioner Of Labor,1,0
Pike,Absentee by Mail,304,Commissioner Of Labor,300,4
Pike,Advance in Person,4478,Commissioner Of Labor,4422,56
Pike,Election Day,3752,Commissioner Of Labor,3666,86
Pike,Provisional,9,Commissioner Of Labor,9,0
Polk,Absentee by Mail,447,Commissioner Of Labor,441,6
Polk,Advance in Person,7744,Commissioner Of Labor,7595,149
Polk,Election Day,4668,Commissioner Of Labor,4533,135
Polk,Provisional,2,Commissioner Of Labor,1,1
Pulaski,Absentee by Mail,232,Commissioner Of Labor,219,13
Pulaski,Advance in Person,2522,Commissioner Of Labor,2421,101
Pulaski,Election Day,868,Commissioner Of Labor,817,51
Pulaski,Provisional,0,Commissioner Of Labor,0,0
Putnam,Absentee by Mail,598,Commissioner Of Labor,591,7
Putnam,Advance in Person,4858,Commissioner Of Labor,4769,89
Putnam,Election Day,3865,Commissioner Of Labor,3754,111
Putnam,Provisional,14,Commissioner Of Labor,13,1
Quitman,Absentee by Mail,60,Commissioner Of Labor,52,8
Quitman,Advance in Person,451,Commissioner Of Labor,427,24
Quitman,Election Day,429,Commissioner Of Labor,410,19
Quitman,Provisional,0,Commissioner Of Labor,0,0
Rabun,Absentee by Mail,843,Commissioner Of Labor,815,28
Rabun,Advance in Person,4889,Commissioner Of Labor,4777,112
Rabun,Election Day,1846,Commissioner Of Labor,1784,62
Rabun,Provisional,0,Commissioner Of Labor,0,0
Randolph,Absentee by Mail,313,Commissioner Of Labor,301,12
Randolph,Advance in Person,1232,Commissioner Of Labor,1196,36
Randolph,Election Day,1243,Commissioner Of Labor,1204,39
Randolph,Provisional,1,Commissioner Of Labor,1,0
Richmond,Absentee by Mail,5314,Commissioner Of Labor,5217,97
Richmond,Advance in Person,28737,Commissioner Of Labor,28233,504
Richmond,Election Day,35992,Commissioner Of Labor,35144,848
Richmond,Provisional,112,Commissioner Of Labor,107,5
Rockdale,Absentee by Mail,1853,Commissioner Of Labor,1822,31
Rockdale,Advance in Person,22789,Commissioner Of Labor,22440,349
Rockdale,Election Day,11958,Commissioner Of Labor,11712,246
Rockdale,Provisional,55,Commissioner Of Labor,50,5
Schley,Absentee by Mail,96,Commissioner Of Labor,96,0
Schley,Advance in Person,1321,Commissioner Of Labor,1287,34
Schley,Election Day,514,Commissioner Of Labor,493,21
Schley,Provisional,2,Commissioner Of Labor,2,0
Screven,Absentee by Mail,271,Commissioner Of Labor,262,9
Screven,Advance in Person,2674,Commissioner Of Labor,2592,82
Screven,Election Day,2462,Commissioner Of Labor,2374,88
Screven,Provisional,7,Commissioner Of Labor,7,0
Seminole,Absentee by Mail,264,Commissioner Of Labor,256,8
Seminole,Advance in Person,1078,Commissioner Of Labor,1062,16
Seminole,Election Day,1872,Commissioner Of Labor,1816,56
Seminole,Provisional,13,Commissioner Of Labor,12,1
Spalding,Absentee by Mail,1283,Commissioner Of Labor,1235,48
Spalding,Advance in Person,13046,Commissioner Of Labor,12697,349
Spalding,Election Day,10056,Commissioner Of Labor,9791,265
Spalding,Provisional,32,Commissioner Of Labor,28,4
Stephens,Absentee by Mail,536,Commissioner Of Labor,522,14
Stephens,Advance in Person,6139,Commissioner Of Labor,6005,134
Stephens,Election Day,2394,Commissioner Of Labor,2322,72
Stephens,Provisional,18,Commissioner Of Labor,17,1
Stewart,Absentee by Mail,233,Commissioner Of Labor,216,17
Stewart,Advance in Person,694,Commissioner Of Labor,646,48
Stewart,Election Day,857,Commissioner Of Labor,770,87
Stewart,Provisional,35,Commissioner Of Labor,34,1
Sumter,Absentee by Mail,877,Commissioner Of Labor,851,26
Sumter,Advance in Person,5531,Commissioner Of Labor,5403,128
Sumter,Election Day,4148,Commissioner Of Labor,4017,131
Sumter,Provisional,0,Commissioner Of Labor,0,0
Talbot,Absentee by Mail,285,Commissioner Of Labor,263,22
Talbot,Advance in Person,772,Commissioner Of Labor,745,27
Talbot,Election Day,1895,Commissioner Of Labor,1814,81
Talbot,Provisional,2,Commissioner Of Labor,2,0
Taliaferro,Absentee by Mail,162,Commissioner Of Labor,145,17
Taliaferro,Advance in Person,441,Commissioner Of Labor,403,38
Taliaferro,Election Day,314,Commissioner Of Labor,286,28
Taliaferro,Provisional,4,Commissioner Of Labor,4,0
Tattnall,Absentee by Mail,392,Commissioner Of Labor,385,7
Tattnall,Advance in Person,3539,Commissioner Of Labor,3432,107
Tattnall,Election Day,2708,Commissioner Of Labor,2620,88
Tattnall,Provisional,8,Commissioner Of Labor,8,0
Taylor,Absentee by Mail,243,Commissioner Of Labor,236,7
Taylor,Advance in Person,1843,Commissioner Of Labor,1810,33
Taylor,Election Day,1179,Commissioner Of Labor,1139,40
Taylor,Provisional,29,Commissioner Of Labor,29,0
Telfair,Absentee by Mail,331,Commissioner Of Labor,323,8
Telfair,Advance in Person,1676,Commissioner Of Labor,1604,72
Telfair,Election Day,1624,Commissioner Of Labor,1556,68
Telfair,Provisional,1,Commissioner Of Labor,1,0
Terrell,Absentee by Mail,327,Commissioner Of Labor,321,6
Terrell,Advance in Person,1612,Commissioner Of Labor,1571,41
Terrell,Election Day,1991,Commissioner Of Labor,1912,79
Terrell,Provisional,9,Commissioner Of Labor,9,0
Thomas,Absentee by Mail,991,Commissioner Of Labor,975,16
Thomas,Advance in Person,8376,Commissioner Of Labor,8203,173
Thomas,Election Day,7874,Commissioner Of Labor,7681,193
Thomas,Provisional,3,Commissioner Of Labor,3,0
Tift,Absentee by Mail,561,Commissioner Of Labor,543,18
Tift,Advance in Person,7646,Commissioner Of Labor,7455,191
Tift,Election Day,5462,Commissioner Of Labor,5281,181
Tift,Provisional,4,Commissioner Of Labor,3,1
Toombs,Absentee by Mail,681,Commissioner Of Labor,655,26
Toombs,Advance in Person,4860,Commissioner Of Labor,4726,134
Toombs,Election Day,3310,Commissioner Of Labor,3221,89
Toombs,Provisional,9,Commissioner Of Labor,9,0
Towns,Absentee by Mail,284,Commissioner Of Labor,276,8
Towns,Advance in Person,4009,Commissioner Of Labor,3897,112
Towns,Election Day,1839,Commissioner Of Labor,1792,47
Towns,Provisional,0,Commissioner Of Labor,0,0
Treutlen,Absentee by Mail,146,Commissioner Of Labor,135,11
Treutlen,Advance in Person,1659,Commissioner Of Labor,1586,73
Treutlen,Election Day,805,Commissioner Of Labor,769,36
Treutlen,Provisional,4,Commissioner Of Labor,4,0
Troup,Absentee by Mail,1264,Commissioner Of Labor,1227,37
Troup,Advance in Person,11226,Commissioner Of Labor,11014,212
Troup,Election Day,11173,Commissioner Of Labor,10903,270
Troup,Provisional,250,Commissioner Of Labor,241,9
Turner,Absentee by Mail,148,Commissioner Of Labor,147,1
Turner,Advance in Person,1922,Commissioner Of Labor,1852,70
Turner,Election Day,1199,Commissioner Of Labor,1166,33
Turner,Provisional,5,Commissioner Of Labor,5,0
Twiggs,Absentee by Mail,275,Commissioner Of Labor,267,8
Twiggs,Advance in Person,1531,Commissioner Of Labor,1484,47
Twiggs,Election Day,1981,Commissioner Of Labor,1908,73
Twiggs,Provisional,5,Commissioner Of Labor,5,0
Union,Absentee by Mail,482,Commissioner Of Labor,470,12
Union,Advance in Person,6626,Commissioner Of Labor,6513,113
Union,Election Day,4755,Commissioner Of Labor,4613,142
Union,Provisional,2,Commissioner Of Labor,2,0
Upson,Absentee by Mail,602,Commissioner Of Labor,589,13
Upson,Advance in Person,6729,Commissioner Of Labor,6572,157
Upson,Election Day,3227,Commissioner Of Labor,3147,80
Upson,Provisional,10,Commissioner Of Labor,9,1
Walker,Absentee by Mail,813,Commissioner Of Labor,793,20
Walker,Advance in Person,11133,Commissioner Of Labor,10895,238
Walker,Election Day,9505,Commissioner Of Labor,9238,267
Walker,Provisional,39,Commissioner Of Labor,38,1
Walton,Absentee by Mail,1769,Commissioner Of Labor,1734,35
Walton,Advance in Person,14370,Commissioner Of Labor,14106,264
Walton,Election Day,22496,Commissioner Of Labor,22024,472
Walton,Provisional,51,Commissioner Of Labor,49,2
Ware,Absentee by Mail,627,Commissioner Of Labor,614,13
Ware,Advance in Person,5460,Commissioner Of Labor,5388,72
Ware,Election Day,4917,Commissioner Of Labor,4804,113
Ware,Provisional,12,Commissioner Of Labor,12,0
Warren,Absentee by Mail,187,Commissioner Of Labor,182,5
Warren,Advance in Person,1267,Commissioner Of Labor,1219,48
Warren,Election Day,806,Commissioner Of Labor,775,31
Warren,Provisional,1,Commissioner Of Labor,1,0
Washington,Absentee by Mail,727,Commissioner Of Labor,701,26
Washington,Advance in Person,3907,Commissioner Of Labor,3762,145
Washington,Election Day,3525,Commissioner Of Labor,3338,187
Washington,Provisional,10,Commissioner Of Labor,10,0
Wayne,Absentee by Mail,501,Commissioner Of Labor,492,9
Wayne,Advance in Person,5868,Commissioner Of Labor,5717,151
Wayne,Election Day,3753,Commissioner Of Labor,3639,114
Wayne,Provisional,10,Commissioner Of Labor,9,1
Webster,Absentee by Mail,152,Commissioner Of Labor,149,3
Webster,Advance in Person,544,Commissioner Of Labor,530,14
Webster,Election Day,404,Commissioner Of Labor,390,14
Webster,Provisional,0,Commissioner Of Labor,0,0
Wheeler,Absentee by Mail,115,Commissioner Of Labor,115,0
Wheeler,Advance in Person,974,Commissioner Of Labor,945,29
Wheeler,Election Day,838,Commissioner Of Labor,811,27
Wheeler,Provisional,4,Commissioner Of Labor,4,0
White,Absentee by Mail,537,Commissioner Of Labor,526,11
White,Advance in Person,5408,Commissioner Of Labor,5310,98
White,Election Day,5489,Commissioner Of Labor,5379,110
White,Provisional,6,Commissioner Of Labor,6,0
Whitfield,Absentee by Mail,1017,Commissioner Of Labor,993,24
Whitfield,Advance in Person,9610,Commissioner Of Labor,9409,201
Whitfield,Election Day,16675,Commissioner Of Labor,16163,512
Whitfield,Provisional,25,Commissioner Of Labor,24,1
Wilcox,Absentee by Mail,205,Commissioner Of Labor,198,7
Wilcox,Advance in Person,1202,Commissioner Of Labor,1175,27
Wilcox,Election Day,1408,Commissioner Of Labor,1356,52
Wilcox,Provisional,0,Commissioner Of Labor,0,0
Wilkes,Absentee by Mail,301,Commissioner Of Labor,287,14
Wilkes,Advance in Person,2075,Commissioner Of Labor,2009,66
Wilkes,Election Day,1995,Commissioner Of Labor,1931,64
Wilkes,Provisional,6,Commissioner Of Labor,6,0
Wilkinson,Absentee by Mail,270,Commissioner Of Labor,260,10
Wilkinson,Advance in Person,1567,Commissioner Of Labor,1517,50
Wilkinson,Election Day,2427,Commissioner Of Labor,2320,107
Wilkinson,Provisional,1,Commissioner Of Labor,1,0
Worth,Absentee by Mail,305,Commissioner Of Labor,300,5
Worth,Advance in Person,3108,Commissioner Of Labor,3044,64
Worth,Election Day,4418,Commissioner Of Labor,4312,106
Worth,Provisional,15,Commissioner Of Labor,15,0
Appling,Absentee by Mail,530,"Public Service Commission, District 3 - Metro-Atlanta",513,17
Appling,Advance in Person,3298,"Public Service Commission, District 3 - Metro-Atlanta",3206,92
Appling,Election Day,2978,"Public Service Commission, District 3 - Metro-Atlanta",2878,100
Appling,Provisional,3,"Public Service Commission, District 3 - Metro-Atlanta",3,0
Atkinson,Absentee by Mail,88,"Public Service Commission, District 3 - Metro-Atlanta",88,0
Atkinson,Advance in Person,1285,"Public Service Commission, District 3 - Metro-Atlanta",1223,62
Atkinson,Election Day,1147,"Public Service Commission, District 3 - Metro-Atlanta",1087,60
Atkinson,Provisional,2,"Public Service Commission, District 3 - Metro-Atlanta",2,0
Bacon,Absentee by Mail,174,"Public Service Commission, District 3 - Metro-Atlanta",171,3
Bacon,Advance in Person,2828,"Public Service Commission, District 3 - Metro-Atlanta",2768,60
Bacon,Election Day,827,"Public Service Commission, District 3 - Metro-Atlanta",781,46
Bacon,Provisional,1,"Public Service Commission, District 3 - Metro-Atlanta",1,0
Baker,Absentee by Mail,141,"Public Service Commission, District 3 - Metro-Atlanta",133,8
Baker,Advance in Person,485,"Public Service Commission, District 3 - Metro-Atlanta",462,23
Baker,Election Day,665,"Public Service Commission, District 3 - Metro-Atlanta",626,39
Baker,Provisional,2,"Public Service Commission, District 3 - Metro-Atlanta",2,0
Baldwin,Absentee by Mail,1158,"Public Service Commission, District 3 - Metro-Atlanta",1134,24
Baldwin,Advance in Person,8295,"Public Service Commission, District 3 - Metro-Atlanta",8039,256
Baldwin,Election Day,6180,"Public Service Commission, District 3 - Metro-Atlanta",5974,206
Baldwin,Provisional,3,"Public Service Commission, District 3 - Metro-Atlanta",3,0
Banks,Absentee by Mail,223,"Public Service Commission, District 3 - Metro-Atlanta",218,5
Banks,Advance in Person,2771,"Public Service Commission, District 3 - Metro-Atlanta",2723,48
Banks,Election Day,3858,"Public Service Commission, District 3 - Metro-Atlanta",3787,71
Banks,Provisional,1,"Public Service Commission, District 3 - Metro-Atlanta",1,0
Barrow,Absentee by Mail,1263,"Public Service Commission, District 3 - Metro-Atlanta",1235,28
Barrow,Advance in Person,12223,"Public Service Commission, District 3 - Metro-Atlanta",12030,193
Barrow,Election Day,13912,"Public Service Commission, District 3 - Metro-Atlanta",13655,257
Barrow,Provisional,7,"Public Service Commission, District 3 - Metro-Atlanta",7,0
Bartow,Absentee by Mail,1568,"Public Service Commission, District 3 - Metro-Atlanta",1547,21
Bartow,Advance in Person,16175,"Public Service Commission, District 3 - Metro-Atlanta",15924,251
Bartow,Election Day,19584,"Public Service Commission, District 3 - Metro-Atlanta",19227,357
Bartow,Provisional,32,"Public Service Commission, District 3 - Metro-Atlanta",32,0
Ben Hill,Absentee by Mail,320,"Public Service Commission, District 3 - Metro-Atlanta",312,8
Ben Hill,Advance in Person,3605,"Public Service Commission, District 3 - Metro-Atlanta",3546,59
Ben Hill,Election Day,1608,"Public Service Commission, District 3 - Metro-Atlanta",1566,42
Ben Hill,Provisional,14,"Public Service Commission, District 3 - Metro-Atlanta",12,2
Berrien,Absentee by Mail,322,"Public Service Commission, District 3 - Metro-Atlanta",316,6
Berrien,Advance in Person,3153,"Public Service Commission, District 3 - Metro-Atlanta",3081,72
Berrien,Election Day,2772,"Public Service Commission, District 3 - Metro-Atlanta",2695,77
Berrien,Provisional,5,"Public Service Commission, District 3 - Metro-Atlanta",5,0
Bibb,Absentee by Mail,4461,"Public Service Commission, District 3 - Metro-Atlanta",4402,59
Bibb,Advance in Person,26183,"Public Service Commission, District 3 - Metro-Atlanta",25615,568
Bibb,Election Day,29816,"Public Service Commission, District 3 - Metro-Atlanta",29137,679
Bibb,Provisional,232,"Public Service Commission, District 3 - Metro-Atlanta",231,1
Bleckley,Absentee by Mail,257,"Public Service Commission, District 3 - Metro-Atlanta",249,8
Bleckley,Advance in Person,2805,"Public Service Commission, District 3 - Metro-Atlanta",2725,80
Bleckley,Election Day,1793,"Public Service Commission, District 3 - Metro-Atlanta",1732,61
Bleckley,Provisional,5,"Public Service Commission, District 3 - Metro-Atlanta",5,0
Brantley,Absentee by Mail,188,"Public Service Commission, District 3 - Metro-Atlanta",185,3
Brantley,Advance in Person,2868,"Public Service Commission, District 3 - Metro-Atlanta",2817,51
Brantley,Election Day,2633,"Public Service Commission, District 3 - Metro-Atlanta",2545,88
Brantley,Provisional,5,"Public Service Commission, District 3 - Metro-Atlanta",5,0
Brooks,Absentee by Mail,465,"Public Service Commission, District 3 - Metro-Atlanta",457,8
Brooks,Advance in Person,2417,"Public Service Commission, District 3 - Metro-Atlanta",2370,47
Brooks,Election Day,2814,"Public Service Commission, District 3 - Metro-Atlanta",2743,71
Brooks,Provisional,27,"Public Service Commission, District 3 - Metro-Atlanta",26,1
Bryan,Absentee by Mail,582,"Public Service Commission, District 3 - Metro-Atlanta",570,12
Bryan,Advance in Person,8342,"Public Service Commission, District 3 - Metro-Atlanta",8217,125
Bryan,Election Day,6046,"Public Service Commission, District 3 - Metro-Atlanta",5932,114
Bryan,Provisional,15,"Public Service Commission, District 3 - Metro-Atlanta",15,0
Bulloch,Absentee by Mail,1076,"Public Service Commission, District 3 - Metro-Atlanta",1048,28
Bulloch,Advance in Person,11170,"Public Service Commission, District 3 - Metro-Atlanta",10941,229
Bulloch,Election Day,11297,"Public Service Commission, District 3 - Metro-Atlanta",10990,307
Bulloch,Provisional,140,"Public Service Commission, District 3 - Metro-Atlanta",137,3
Burke,Absentee by Mail,968,"Public Service Commission, District 3 - Metro-Atlanta",948,20
Burke,Advance in Person,3199,"Public Service Commission, District 3 - Metro-Atlanta",3139,60
Burke,Election Day,4552,"Public Service Commission, District 3 - Metro-Atlanta",4441,111
Burke,Provisional,2,"Public Service Commission, District 3 - Metro-Atlanta",2,0
Butts,Absentee by Mail,380,"Public Service Commission, District 3 - Metro-Atlanta",375,5
Butts,Advance in Person,6277,"Public Service Commission, District 3 - Metro-Atlanta",6145,132
Butts,Election Day,2206,"Public Service Commission, District 3 - Metro-Atlanta",2162,44
Butts,Provisional,0,"Public Service Commission, District 3 - Metro-Atlanta",0,0
Calhoun,Absentee by Mail,185,"Public Service Commission, District 3 - Metro-Atlanta",181,4
Calhoun,Advance in Person,607,"Public Service Commission, District 3 - Metro-Atlanta",592,15
Calhoun,Election Day,1107,"Public Service Commission, District 3 - Metro-Atlanta",1081,26
Calhoun,Provisional,0,"Public Service Commission, District 3 - Metro-Atlanta",0,0
Camden,Absentee by Mail,1193,"Public Service Commission, District 3 - Metro-Atlanta",1175,18
Camden,Advance in Person,8085,"Public Service Commission, District 3 - Metro-Atlanta",7956,129
Camden,Election Day,7775,"Public Service Commission, District 3 - Metro-Atlanta",7596,179
Camden,Provisional,8,"Public Service Commission, District 3 - Metro-Atlanta",8,0
Candler,Absentee by Mail,120,"Public Service Commission, District 3 - Metro-Atlanta",117,3
Candler,Advance in Person,2335,"Public Service Commission, District 3 - Metro-Atlanta",2265,70
Candler,Election Day,1083,"Public Service Commission, District 3 - Metro-Atlanta",1050,33
Candler,Provisional,1,"Public Service Commission, District 3 - Metro-Atlanta",1,0
Carroll,Absentee by Mail,1518,"Public Service Commission, District 3 - Metro-Atlanta",1487,31
Carroll,Advance in Person,20100,"Public Service Commission, District 3 - Metro-Atlanta",19781,319
Carroll,Election Day,20121,"Public Service Commission, District 3 - Metro-Atlanta",19731,390
Carroll,Provisional,104,"Public Service Commission, District 3 - Metro-Atlanta",101,3
Catoosa,Absentee by Mail,540,"Public Service Commission, District 3 - Metro-Atlanta",529,11
Catoosa,Advance in Person,13673,"Public Service Commission, District 3 - Metro-Atlanta",13438,235
Catoosa,Election Day,9512,"Public Service Commission, District 3 - Metro-Atlanta",9339,173
Catoosa,Provisional,33,"Public Service Commission, District 3 - Metro-Atlanta",33,0
Charlton,Absentee by Mail,163,"Public Service Commission, District 3 - Metro-Atlanta",158,5
Charlton,Advance in Person,1549,"Public Service Commission, District 3 - Metro-Atlanta",1518,31
Charlton,Election Day,1657,"Public Service Commission, District 3 - Metro-Atlanta",1603,54
Charlton,Provisional,8,"Public Service Commission, District 3 - Metro-Atlanta",8,0
Chatham,Absentee by Mail,6177,"Public Service Commission, District 3 - Metro-Atlanta",6028,149
Chatham,Advance in Person,32338,"Public Service Commission, District 3 - Metro-Atlanta",31762,576
Chatham,Election Day,64823,"Public Service Commission, District 3 - Metro-Atlanta",63226,1597
Chatham,Provisional,205,"Public Service Commission, District 3 - Metro-Atlanta",202,3
Chattahoochee,Absentee by Mail,35,"Public Service Commission, District 3 - Metro-Atlanta",34,1
Chattahoochee,Advance in Person,493,"Public Service Commission, District 3 - Metro-Atlanta",475,18
Chattahoochee,Election Day,574,"Public Service Commission, District 3 - Metro-Atlanta",550,24
Chattahoochee,Provisional,3,"Public Service Commission, District 3 - Metro-Atlanta",3,0
Chattooga,Absentee by Mail,225,"Public Service Commission, District 3 - Metro-Atlanta",222,3
Chattooga,Advance in Person,3452,"Public Service Commission, District 3 - Metro-Atlanta",3369,83
Chattooga,Election Day,3750,"Public Service Commission, District 3 - Metro-Atlanta",3649,101
Chattooga,Provisional,7,"Public Service Commission, District 3 - Metro-Atlanta",7,0
Cherokee,Absentee by Mail,5312,"Public Service Commission, District 3 - Metro-Atlanta",5212,100
Cherokee,Advance in Person,48565,"Public Service Commission, District 3 - Metro-Atlanta",47876,689
Cherokee,Election Day,52422,"Public Service Commission, District 3 - Metro-Atlanta",51247,1175
Cherokee,Provisional,112,"Public Service Commission, District 3 - Metro-Atlanta",107,5
Clarke,Absentee by Mail,3022,"Public Service Commission, District 3 - Metro-Atlanta",2963,59
Clarke,Advance in Person,19957,"Public Service Commission, District 3 - Metro-Atlanta",19582,375
Clarke,Election Day,20282,"Public Service Commission, District 3 - Metro-Atlanta",19698,584
Clarke,Provisional,41,"Public Service Commission, District 3 - Metro-Atlanta",39,2
Clay,Absentee by Mail,143,"Public Service Commission, District 3 - Metro-Atlanta",137,6
Clay,Advance in Person,579,"Public Service Commission, District 3 - Metro-Atlanta",560,19
Clay,Election Day,464,"Public Service Commission, District 3 - Metro-Atlanta",445,19
Clay,Provisional,0,"Public Service Commission, District 3 - Metro-Atlanta",0,0
Clayton,Absentee by Mail,5847,"Public Service Commission, District 3 - Metro-Atlanta",5712,135
Clayton,Advance in Person,47671,"Public Service Commission, District 3 - Metro-Atlanta",47000,671
Clayton,Election Day,38322,"Public Service Commission, District 3 - Metro-Atlanta",37651,671
Clayton,Provisional,372,"Public Service Commission, District 3 - Metro-Atlanta",353,19
Clinch,Absentee by Mail,109,"Public Service Commission, District 3 - Metro-Atlanta",107,2
Clinch,Advance in Person,1236,"Public Service Commission, District 3 - Metro-Atlanta",1187,49
Clinch,Election Day,909,"Public Service Commission, District 3 - Metro-Atlanta",870,39
Clinch,Provisional,4,"Public Service Commission, District 3 - Metro-Atlanta",4,0
Cobb,Absentee by Mail,25901,"Public Service Commission, District 3 - Metro-Atlanta",25412,489
Cobb,Advance in Person,111554,"Public Service Commission, District 3 - Metro-Atlanta",110082,1472
Cobb,Election Day,172926,"Public Service Commission, District 3 - Metro-Atlanta",169515,3411
Cobb,Provisional,1433,"Public Service Commission, District 3 - Metro-Atlanta",1394,39
Coffee,Absentee by Mail,395,"Public Service Commission, District 3 - Metro-Atlanta",388,7
Coffee,Advance in Person,7664,"Public Service Commission, District 3 - Metro-Atlanta",7466,198
Coffee,Election Day,4536,"Public Service Commission, District 3 - Metro-Atlanta",4391,145
Coffee,Provisional,20,"Public Service Commission, District 3 - Metro-Atlanta",19,1
Colquitt,Absentee by Mail,514,"Public Service Commission, District 3 - Metro-Atlanta",506,8
Colquitt,Advance in Person,6071,"Public Service Commission, District 3 - Metro-Atlanta",5904,167
Colquitt,Election Day,6368,"Public Service Commission, District 3 - Metro-Atlanta",6133,235
Colquitt,Provisional,10,"Public Service Commission, District 3 - Metro-Atlanta",10,0
Columbia,Absentee by Mail,2936,"Public Service Commission, District 3 - Metro-Atlanta",2888,48
Columbia,Advance in Person,29686,"Public Service Commission, District 3 - Metro-Atlanta",29353,333
Columbia,Election Day,28969,"Public Service Commission, District 3 - Metro-Atlanta",28385,584
Columbia,Provisional,43,"Public Service Commission, District 3 - Metro-Atlanta",42,1
Cook,Absentee by Mail,244,"Public Service Commission, District 3 - Metro-Atlanta",242,2
Cook,Advance in Person,3069,"Public Service Commission, District 3 - Metro-Atlanta",3015,54
Cook,Election Day,2490,"Public Service Commission, District 3 - Metro-Atlanta",2444,46
Cook,Provisional,0,"Public Service Commission, District 3 - Metro-Atlanta",0,0
Coweta,Absentee by Mail,2812,"Public Service Commission, District 3 - Metro-Atlanta",2758,54
Coweta,Advance in Person,25641,"Public Service Commission, District 3 - Metro-Atlanta",25276,365
Coweta,Election Day,29603,"Public Service Commission, District 3 - Metro-Atlanta",29034,569
Coweta,Provisional,15,"Public Service Commission, District 3 - Metro-Atlanta",15,0
Crawford,Absentee by Mail,234,"Public Service Commission, District 3 - Metro-Atlanta",230,4
Crawford,Advance in Person,2567,"Public Service Commission, District 3 - Metro-Atlanta",2499,68
Crawford,Election Day,2130,"Public Service Commission, District 3 - Metro-Atlanta",2086,44
Crawford,Provisional,3,"Public Service Commission, District 3 - Metro-Atlanta",3,0
Crisp,Absentee by Mail,363,"Public Service Commission, District 3 - Metro-Atlanta",352,11
Crisp,Advance in Person,4191,"Public Service Commission, District 3 - Metro-Atlanta",4069,122
Crisp,Election Day,2470,"Public Service Commission, District 3 - Metro-Atlanta",2340,130
Crisp,Provisional,26,"Public Service Commission, District 3 - Metro-Atlanta",22,4
Dade,Absentee by Mail,129,"Public Service Commission, District 3 - Metro-Atlanta",119,10
Dade,Advance in Person,2561,"Public Service Commission, District 3 - Metro-Atlanta",2465,96
Dade,Election Day,2760,"Public Service Commission, District 3 - Metro-Atlanta",2662,98
Dade,Provisional,12,"Public Service Commission, District 3 - Metro-Atlanta",12,0
Dawson,Absentee by Mail,439,"Public Service Commission, District 3 - Metro-Atlanta",436,3
Dawson,Advance in Person,7020,"Public Service Commission, District 3 - Metro-Atlanta",6922,98
Dawson,Election Day,4111,"Public Service Commission, District 3 - Metro-Atlanta",4032,79
Dawson,Provisional,11,"Public Service Commission, District 3 - Metro-Atlanta",11,0
DeKalb,Absentee by Mail,19672,"Public Service Commission, District 3 - Metro-Atlanta",19203,469
DeKalb,Advance in Person,150814,"Public Service Commission, District 3 - Metro-Atlanta",148174,2640
DeKalb,Election Day,140482,"Public Service Commission, District 3 - Metro-Atlanta",136973,3509
DeKalb,Provisional,1773,"Public Service Commission, District 3 - Metro-Atlanta",1696,77
Decatur,Absentee by Mail,548,"Public Service Commission, District 3 - Metro-Atlanta",535,13
Decatur,Advance in Person,4260,"Public Service Commission, District 3 - Metro-Atlanta",4169,91
Decatur,Election Day,4235,"Public Service Commission, District 3 - Metro-Atlanta",4125,110
Decatur,Provisional,103,"Public Service Commission, District 3 - Metro-Atlanta",98,5
Dodge,Absentee by Mail,448,"Public Service Commission, District 3 - Metro-Atlanta",433,15
Dodge,Advance in Person,3411,"Public Service Commission, District 3 - Metro-Atlanta",3263,148
Dodge,Election Day,3192,"Public Service Commission, District 3 - Metro-Atlanta",3045,147
Dodge,Provisional,10,"Public Service Commission, District 3 - Metro-Atlanta",10,0
Dooly,Absentee by Mail,196,"Public Service Commission, District 3 - Metro-Atlanta",191,5
Dooly,Advance in Person,1889,"Public Service Commission, District 3 - Metro-Atlanta",1813,76
Dooly,Election Day,1708,"Public Service Commission, District 3 - Metro-Atlanta",1642,66
Dooly,Provisional,2,"Public Service Commission, District 3 - Metro-Atlanta",1,1
Dougherty,Absentee by Mail,1944,"Public Service Commission, District 3 - Metro-Atlanta",1901,43
Dougherty,Advance in Person,11332,"Public Service Commission, District 3 - Metro-Atlanta",11127,205
Dougherty,Election Day,18021,"Public Service Commission, District 3 - Metro-Atlanta",17587,434
Dougherty,Provisional,128,"Public Service Commission, District 3 - Metro-Atlanta",123,5
Douglas,Absentee by Mail,3233,"Public Service Commission, District 3 - Metro-Atlanta",3183,50
Douglas,Advance in Person,30219,"Public Service Commission, District 3 - Metro-Atlanta",29871,348
Douglas,Election Day,21745,"Public Service Commission, District 3 - Metro-Atlanta",21407,338
Douglas,Provisional,58,"Public Service Commission, District 3 - Metro-Atlanta",58,0
Early,Absentee by Mail,473,"Public Service Commission, District 3 - Metro-Atlanta",459,14
Early,Advance in Person,1569,"Public Service Commission, District 3 - Metro-Atlanta",1544,25
Early,Election Day,2089,"Public Service Commission, District 3 - Metro-Atlanta",2039,50
Early,Provisional,4,"Public Service Commission, District 3 - Metro-Atlanta",4,0
Echols,Absentee by Mail,35,"Public Service Commission, District 3 - Metro-Atlanta",35,0
Echols,Advance in Person,767,"Public Service Commission, District 3 - Metro-Atlanta",748,19
Echols,Election Day,341,"Public Service Commission, District 3 - Metro-Atlanta",329,12
Echols,Provisional,0,"Public Service Commission, District 3 - Metro-Atlanta",0,0
Effingham,Absentee by Mail,750,"Public Service Commission, District 3 - Metro-Atlanta",734,16
Effingham,Advance in Person,10717,"Public Service Commission, District 3 - Metro-Atlanta",10551,166
Effingham,Election Day,11898,"Public Service Commission, District 3 - Metro-Atlanta",11678,220
Effingham,Provisional,6,"Public Service Commission, District 3 - Metro-Atlanta",6,0
Elbert,Absentee by Mail,563,"Public Service Commission, District 3 - Metro-Atlanta",559,4
Elbert,Advance in Person,3722,"Public Service Commission, District 3 - Metro-Atlanta",3617,105
Elbert,Election Day,3034,"Public Service Commission, District 3 - Metro-Atlanta",2948,86
Elbert,Provisional,69,"Public Service Commission, District 3 - Metro-Atlanta",67,2
Emanuel,Absentee by Mail,390,"Public Service Commission, District 3 - Metro-Atlanta",380,10
Emanuel,Advance in Person,3424,"Public Service Commission, District 3 - Metro-Atlanta",3334,90
Emanuel,Election Day,3896,"Public Service Commission, District 3 - Metro-Atlanta",3725,171
Emanuel,Provisional,6,"Public Service Commission, District 3 - Metro-Atlanta",6,0
Evans,Absentee by Mail,199,"Public Service Commission, District 3 - Metro-Atlanta",194,5
Evans,Advance in Person,2162,"Public Service Commission, District 3 - Metro-Atlanta",2083,79
Evans,Election Day,1086,"Public Service Commission, District 3 - Metro-Atlanta",1046,40
Evans,Provisional,0,"Public Service Commission, District 3 - Metro-Atlanta",0,0
Fannin,Absentee by Mail,658,"Public Service Commission, District 3 - Metro-Atlanta",646,12
Fannin,Advance in Person,5341,"Public Service Commission, District 3 - Metro-Atlanta",5250,91
Fannin,Election Day,5204,"Public Service Commission, District 3 - Metro-Atlanta",5073,131
Fannin,Provisional,16,"Public Service Commission, District 3 - Metro-Atlanta",15,1
Fayette,Absentee by Mail,2647,"Public Service Commission, District 3 - Metro-Atlanta",2586,61
Fayette,Advance in Person,31073,"Public Service Commission, District 3 - Metro-Atlanta",30615,458
Fayette,Election Day,24242,"Public Service Commission, District 3 - Metro-Atlanta",23693,549
Fayette,Provisional,36,"Public Service Commission, District 3 - Metro-Atlanta",35,1
Floyd,Absentee by Mail,1260,"Public Service Commission, District 3 - Metro-Atlanta",1228,32
Floyd,Advance in Person,13688,"Public Service Commission, District 3 - Metro-Atlanta",13454,234
Floyd,Election Day,15277,"Public Service Commission, District 3 - Metro-Atlanta",14889,388
Floyd,Provisional,113,"Public Service Commission, District 3 - Metro-Atlanta",107,6
Forsyth,Absentee by Mail,4428,"Public Service Commission, District 3 - Metro-Atlanta",4314,114
Forsyth,Advance in Person,52559,"Public Service Commission, District 3 - Metro-Atlanta",51787,772
Forsyth,Election Day,36252,"Public Service Commission, District 3 - Metro-Atlanta",35473,779
Forsyth,Provisional,59,"Public Service Commission, District 3 - Metro-Atlanta",58,1
Franklin,Absentee by Mail,388,"Public Service Commission, District 3 - Metro-Atlanta",385,3
Franklin,Advance in Person,3502,"Public Service Commission, District 3 - Metro-Atlanta",3455,47
Franklin,Election Day,4259,"Public Service Commission, District 3 - Metro-Atlanta",4163,96
Franklin,Provisional,0,"Public Service Commission, District 3 - Metro-Atlanta",0,0
Fulton,Absentee by Mail,17842,"Public Service Commission, District 3 - Metro-Atlanta",17239,603
Fulton,Advance in Person,224522,"Public Service Commission, District 3 - Metro-Atlanta",220098,4424
Fulton,Election Day,179442,"Public Service Commission, District 3 - Metro-Atlanta",174571,4871
Fulton,Provisional,1982,"Public Service Commission, District 3 - Metro-Atlanta",1883,99
Gilmer,Absentee by Mail,559,"Public Service Commission, District 3 - Metro-Atlanta",554,5
Gilmer,Advance in Person,6295,"Public Service Commission, District 3 - Metro-Atlanta",6158,137
Gilmer,Election Day,5617,"Public Service Commission, District 3 - Metro-Atlanta",5451,166
Gilmer,Provisional,39,"Public Service Commission, District 3 - Metro-Atlanta",35,4
Glascock,Absentee by Mail,81,"Public Service Commission, District 3 - Metro-Atlanta",79,2
Glascock,Advance in Person,652,"Public Service Commission, District 3 - Metro-Atlanta",630,22
Glascock,Election Day,567,"Public Service Commission, District 3 - Metro-Atlanta",531,36
Glascock,Provisional,1,"Public Service Commission, District 3 - Metro-Atlanta",1,0
Glynn,Absentee by Mail,1812,"Public Service Commission, District 3 - Metro-Atlanta",1787,25
Glynn,Advance in Person,17510,"Public Service Commission, District 3 - Metro-Atlanta",17184,326
Glynn,Election Day,13179,"Public Service Commission, District 3 - Metro-Atlanta",12858,321
Glynn,Provisional,147,"Public Service Commission, District 3 - Metro-Atlanta",138,9
Gordon,Absentee by Mail,547,"Public Service Commission, District 3 - Metro-Atlanta",529,18
Gordon,Advance in Person,8119,"Public Service Commission, District 3 - Metro-Atlanta",7926,193
Gordon,Election Day,9106,"Public Service Commission, District 3 - Metro-Atlanta",8876,230
Gordon,Provisional,32,"Public Service Commission, District 3 - Metro-Atlanta",31,1
Grady,Absentee by Mail,400,"Public Service Commission, District 3 - Metro-Atlanta",390,10
Grady,Advance in Person,3857,"Public Service Commission, District 3 - Metro-Atlanta",3789,68
Grady,Election Day,4099,"Public Service Commission, District 3 - Metro-Atlanta",4010,89
Grady,Provisional,14,"Public Service Commission, District 3 - Metro-Atlanta",13,1
Greene,Absentee by Mail,623,"Public Service Commission, District 3 - Metro-Atlanta",611,12
Greene,Advance in Person,5593,"Public Service Commission, District 3 - Metro-Atlanta",5524,69
Greene,Election Day,2773,"Public Service Commission, District 3 - Metro-Atlanta",2714,59
Greene,Provisional,6,"Public Service Commission, District 3 - Metro-Atlanta",6,0
Gwinnett,Absentee by Mail,20397,"Public Service Commission, District 3 - Metro-Atlanta",20084,313
Gwinnett,Advance in Person,137166,"Public Service Commission, District 3 - Metro-Atlanta",135278,1888
Gwinnett,Election Day,155146,"Public Service Commission, District 3 - Metro-Atlanta",152272,2874
Gwinnett,Provisional,2209,"Public Service Commission, District 3 - Metro-Atlanta",2157,52
Habersham,Absentee by Mail,853,"Public Service Commission, District 3 - Metro-Atlanta",835,18
Habersham,Advance in Person,10023,"Public Service Commission, District 3 - Metro-Atlanta",9814,209
Habersham,Election Day,4619,"Public Service Commission, District 3 - Metro-Atlanta",4489,130
Habersham,Provisional,5,"Public Service Commission, District 3 - Metro-Atlanta",5,0
Hall,Absentee by Mail,3493,"Public Service Commission, District 3 - Metro-Atlanta",3430,63
Hall,Advance in Person,24348,"Public Service Commission, District 3 - Metro-Atlanta",23915,433
Hall,Election Day,39441,"Public Service Commission, District 3 - Metro-Atlanta",38617,824
Hall,Provisional,124,"Public Service Commission, District 3 - Metro-Atlanta",119,5
Hancock,Absentee by Mail,490,"Public Service Commission, District 3 - Metro-Atlanta",474,16
Hancock,Advance in Person,1531,"Public Service Commission, District 3 - Metro-Atlanta",1470,61
Hancock,Election Day,1518,"Public Service Commission, District 3 - Metro-Atlanta",1439,79
Hancock,Provisional,9,"Public Service Commission, District 3 - Metro-Atlanta",7,2
Haralson,Absentee by Mail,393,"Public Service Commission, District 3 - Metro-Atlanta",387,6
Haralson,Advance in Person,4202,"Public Service Commission, District 3 - Metro-Atlanta",4098,104
Haralson,Election Day,5990,"Public Service Commission, District 3 - Metro-Atlanta",5886,104
Haralson,Provisional,0,"Public Service Commission, District 3 - Metro-Atlanta",0,0
Harris,Absentee by Mail,729,"Public Service Commission, District 3 - Metro-Atlanta",717,12
Harris,Advance in Person,7251,"Public Service Commission, District 3 - Metro-Atlanta",7155,96
Harris,Election Day,7992,"Public Service Commission, District 3 - Metro-Atlanta",7809,183
Harris,Provisional,14,"Public Service Commission, District 3 - Metro-Atlanta",14,0
Hart,Absentee by Mail,440,"Public Service Commission, District 3 - Metro-Atlanta",434,6
Hart,Advance in Person,5220,"Public Service Commission, District 3 - Metro-Atlanta",5075,145
Hart,Election Day,3958,"Public Service Commission, District 3 - Metro-Atlanta",3843,115
Hart,Provisional,4,"Public Service Commission, District 3 - Metro-Atlanta",4,0
Heard,Absentee by Mail,278,"Public Service Commission, District 3 - Metro-Atlanta",274,4
Heard,Advance in Person,1427,"Public Service Commission, District 3 - Metro-Atlanta",1395,32
Heard,Election Day,2346,"Public Service Commission, District 3 - Metro-Atlanta",2295,51
Heard,Provisional,4,"Public Service Commission, District 3 - Metro-Atlanta",4,0
Henry,Absentee by Mail,4997,"Public Service Commission, District 3 - Metro-Atlanta",4890,107
Henry,Advance in Person,58658,"Public Service Commission, District 3 - Metro-Atlanta",57926,732
Henry,Election Day,34710,"Public Service Commission, District 3 - Metro-Atlanta",34079,631
Henry,Provisional,193,"Public Service Commission, District 3 - Metro-Atlanta",185,8
Houston,Absentee by Mail,3190,"Public Service Commission, District 3 - Metro-Atlanta",3123,67
Houston,Advance in Person,34816,"Public Service Commission, District 3 - Metro-Atlanta",34378,438
Houston,Election Day,21152,"Public Service Commission, District 3 - Metro-Atlanta",20774,378
Houston,Provisional,74,"Public Service Commission, District 3 - Metro-Atlanta",70,4
Irwin,Absentee by Mail,133,"Public Service Commission, District 3 - Metro-Atlanta",132,1
Irwin,Advance in Person,2048,"Public Service Commission, District 3 - Metro-Atlanta",1991,57
Irwin,Election Day,1375,"Public Service Commission, District 3 - Metro-Atlanta",1339,36
Irwin,Provisional,8,"Public Service Commission, District 3 - Metro-Atlanta",8,0
Jackson,Absentee by Mail,1019,"Public Service Commission, District 3 - Metro-Atlanta",1002,17
Jackson,Advance in Person,14919,"Public Service Commission, District 3 - Metro-Atlanta",14708,211
Jackson,Election Day,10951,"Public Service Commission, District 3 - Metro-Atlanta",10742,209
Jackson,Provisional,10,"Public Service Commission, District 3 - Metro-Atlanta",9,1
Jasper,Absentee by Mail,421,"Public Service Commission, District 3 - Metro-Atlanta",416,5
Jasper,Advance in Person,2981,"Public Service Commission, District 3 - Metro-Atlanta",2921,60
Jasper,Election Day,2505,"Public Service Commission, District 3 - Metro-Atlanta",2465,40
Jasper,Provisional,38,"Public Service Commission, District 3 - Metro-Atlanta",37,1
Jeff Davis,Absentee by Mail,229,"Public Service Commission, District 3 - Metro-Atlanta",221,8
Jeff Davis,Advance in Person,2680,"Public Service Commission, District 3 - Metro-Atlanta",2582,98
Jeff Davis,Election Day,1906,"Public Service Commission, District 3 - Metro-Atlanta",1811,95
Jeff Davis,Provisional,0,"Public Service Commission, District 3 - Metro-Atlanta",0,0
Jefferson,Absentee by Mail,607,"Public Service Commission, District 3 - Metro-Atlanta",585,22
Jefferson,Advance in Person,2803,"Public Service Commission, District 3 - Metro-Atlanta",2707,96
Jefferson,Election Day,3346,"Public Service Commission, District 3 - Metro-Atlanta",3227,119
Jefferson,Provisional,11,"Public Service Commission, District 3 - Metro-Atlanta",10,1
Jenkins,Absentee by Mail,188,"Public Service Commission, District 3 - Metro-Atlanta",184,4
Jenkins,Advance in Person,1557,"Public Service Commission, District 3 - Metro-Atlanta",1509,48
Jenkins,Election Day,1111,"Public Service Commission, District 3 - Metro-Atlanta",1087,24
Jenkins,Provisional,16,"Public Service Commission, District 3 - Metro-Atlanta",16,0
Johnson,Absentee by Mail,236,"Public Service Commission, District 3 - Metro-Atlanta",223,13
Johnson,Advance in Person,1970,"Public Service Commission, District 3 - Metro-Atlanta",1898,72
Johnson,Election Day,1277,"Public Service Commission, District 3 - Metro-Atlanta",1219,58
Johnson,Provisional,0,"Public Service Commission, District 3 - Metro-Atlanta",0,0
Jones,Absentee by Mail,784,"Public Service Commission, District 3 - Metro-Atlanta",764,20
Jones,Advance in Person,6968,"Public Service Commission, District 3 - Metro-Atlanta",6827,141
Jones,Election Day,4680,"Public Service Commission, District 3 - Metro-Atlanta",4586,94
Jones,Provisional,9,"Public Service Commission, District 3 - Metro-Atlanta",9,0
Lamar,Absentee by Mail,404,"Public Service Commission, District 3 - Metro-Atlanta",397,7
Lamar,Advance in Person,3820,"Public Service Commission, District 3 - Metro-Atlanta",3743,77
Lamar,Election Day,3122,"Public Service Commission, District 3 - Metro-Atlanta",3063,59
Lamar,Provisional,11,"Public Service Commission, District 3 - Metro-Atlanta",11,0
Lanier,Absentee by Mail,108,"Public Service Commission, District 3 - Metro-Atlanta",104,4
Lanier,Advance in Person,1661,"Public Service Commission, District 3 - Metro-Atlanta",1616,45
Lanier,Election Day,910,"Public Service Commission, District 3 - Metro-Atlanta",867,43
Lanier,Provisional,2,"Public Service Commission, District 3 - Metro-Atlanta",2,0
Laurens,Absentee by Mail,1286,"Public Service Commission, District 3 - Metro-Atlanta",1253,33
Laurens,Advance in Person,8485,"Public Service Commission, District 3 - Metro-Atlanta",8254,231
Laurens,Election Day,9168,"Public Service Commission, District 3 - Metro-Atlanta",8902,266
Laurens,Provisional,13,"Public Service Commission, District 3 - Metro-Atlanta",13,0
Lee,Absentee by Mail,480,"Public Service Commission, District 3 - Metro-Atlanta",472,8
Lee,Advance in Person,5681,"Public Service Commission, District 3 - Metro-Atlanta",5604,77
Lee,Election Day,7388,"Public Service Commission, District 3 - Metro-Atlanta",7265,123
Lee,Provisional,6,"Public Service Commission, District 3 - Metro-Atlanta",6,0
Liberty,Absentee by Mail,950,"Public Service Commission, District 3 - Metro-Atlanta",934,16
Liberty,Advance in Person,8143,"Public Service Commission, District 3 - Metro-Atlanta",8025,118
Liberty,Election Day,6265,"Public Service Commission, District 3 - Metro-Atlanta",6155,110
Liberty,Provisional,10,"Public Service Commission, District 3 - Metro-Atlanta",9,1
Lincoln,Absentee by Mail,350,"Public Service Commission, District 3 - Metro-Atlanta",349,1
Lincoln,Advance in Person,1937,"Public Service Commission, District 3 - Metro-Atlanta",1897,40
Lincoln,Election Day,1680,"Public Service Commission, District 3 - Metro-Atlanta",1625,55
Lincoln,Provisional,2,"Public Service Commission, District 3 - Metro-Atlanta",2,0
Long,Absentee by Mail,169,"Public Service Commission, District 3 - Metro-Atlanta",167,2
Long,Advance in Person,1971,"Public Service Commission, District 3 - Metro-Atlanta",1912,59
Long,Election Day,1848,"Public Service Commission, District 3 - Metro-Atlanta",1787,61
Long,Provisional,10,"Public Service Commission, District 3 - Metro-Atlanta",10,0
Lowndes,Absentee by Mail,1890,"Public Service Commission, District 3 - Metro-Atlanta",1858,32
Lowndes,Advance in Person,21238,"Public Service Commission, District 3 - Metro-Atlanta",20943,295
Lowndes,Election Day,12084,"Public Service Commission, District 3 - Metro-Atlanta",11810,274
Lowndes,Provisional,541,"Public Service Commission, District 3 - Metro-Atlanta",523,18
Lumpkin,Absentee by Mail,467,"Public Service Commission, District 3 - Metro-Atlanta",458,9
Lumpkin,Advance in Person,7377,"Public Service Commission, District 3 - Metro-Atlanta",7263,114
Lumpkin,Election Day,3707,"Public Service Commission, District 3 - Metro-Atlanta",3614,93
Lumpkin,Provisional,7,"Public Service Commission, District 3 - Metro-Atlanta",7,0
Macon,Absentee by Mail,331,"Public Service Commission, District 3 - Metro-Atlanta",319,12
Macon,Advance in Person,2251,"Public Service Commission, District 3 - Metro-Atlanta",2148,103
Macon,Election Day,1635,"Public Service Commission, District 3 - Metro-Atlanta",1572,63
Macon,Provisional,0,"Public Service Commission, District 3 - Metro-Atlanta",0,0
Madison,Absentee by Mail,527,"Public Service Commission, District 3 - Metro-Atlanta",520,7
Madison,Advance in Person,5242,"Public Service Commission, District 3 - Metro-Atlanta",5121,121
Madison,Election Day,5928,"Public Service Commission, District 3 - Metro-Atlanta",5777,151
Madison,Provisional,2,"Public Service Commission, District 3 - Metro-Atlanta",2,0
Marion,Absentee by Mail,241,"Public Service Commission, District 3 - Metro-Atlanta",237,4
Marion,Advance in Person,1222,"Public Service Commission, District 3 - Metro-Atlanta",1187,35
Marion,Election Day,1467,"Public Service Commission, District 3 - Metro-Atlanta",1425,42
Marion,Provisional,1,"Public Service Commission, District 3 - Metro-Atlanta",1,0
McDuffie,Absentee by Mail,868,"Public Service Commission, District 3 - Metro-Atlanta",856,12
McDuffie,Advance in Person,5045,"Public Service Commission, District 3 - Metro-Atlanta",4952,93
McDuffie,Election Day,2879,"Public Service Commission, District 3 - Metro-Atlanta",2818,61
McDuffie,Provisional,0,"Public Service Commission, District 3 - Metro-Atlanta",0,0
McIntosh,Absentee by Mail,440,"Public Service Commission, District 3 - Metro-Atlanta",429,11
McIntosh,Advance in Person,2945,"Public Service Commission, District 3 - Metro-Atlanta",2877,68
McIntosh,Election Day,2023,"Public Service Commission, District 3 - Metro-Atlanta",1952,71
McIntosh,Provisional,0,"Public Service Commission, District 3 - Metro-Atlanta",0,0
Meriwether,Absentee by Mail,483,"Public Service Commission, District 3 - Metro-Atlanta",475,8
Meriwether,Advance in Person,2831,"Public Service Commission, District 3 - Metro-Atlanta",2774,57
Meriwether,Election Day,5325,"Public Service Commission, District 3 - Metro-Atlanta",5183,142
Meriwether,Provisional,11,"Public Service Commission, District 3 - Metro-Atlanta",10,1
Miller,Absentee by Mail,132,"Public Service Commission, District 3 - Metro-Atlanta",126,6
Miller,Advance in Person,1029,"Public Service Commission, District 3 - Metro-Atlanta",971,58
Miller,Election Day,1152,"Public Service Commission, District 3 - Metro-Atlanta",1102,50
Miller,Provisional,2,"Public Service Commission, District 3 - Metro-Atlanta",2,0
Mitchell,Absentee by Mail,564,"Public Service Commission, District 3 - Metro-Atlanta",556,8
Mitchell,Advance in Person,3343,"Public Service Commission, District 3 - Metro-Atlanta",3271,72
Mitchell,Election Day,3539,"Public Service Commission, District 3 - Metro-Atlanta",3455,84
Mitchell,Provisional,9,"Public Service Commission, District 3 - Metro-Atlanta",8,1
Monroe,Absentee by Mail,696,"Public Service Commission, District 3 - Metro-Atlanta",691,5
Monroe,Advance in Person,6311,"Public Service Commission, District 3 - Metro-Atlanta",6163,148
Monroe,Election Day,5925,"Public Service Commission, District 3 - Metro-Atlanta",5788,137
Monroe,Provisional,10,"Public Service Commission, District 3 - Metro-Atlanta",9,1
Montgomery,Absentee by Mail,211,"Public Service Commission, District 3 - Metro-Atlanta",206,5
Montgomery,Advance in Person,1416,"Public Service Commission, District 3 - Metro-Atlanta",1368,48
Montgomery,Election Day,1901,"Public Service Commission, District 3 - Metro-Atlanta",1830,71
Montgomery,Provisional,0,"Public Service Commission, District 3 - Metro-Atlanta",0,0
Morgan,Absentee by Mail,410,"Public Service Commission, District 3 - Metro-Atlanta",401,9
Morgan,Advance in Person,5406,"Public Service Commission, District 3 - Metro-Atlanta",5291,115
Morgan,Election Day,3738,"Public Service Commission, District 3 - Metro-Atlanta",3654,84
Morgan,Provisional,4,"Public Service Commission, District 3 - Metro-Atlanta",4,0
Murray,Absentee by Mail,265,"Public Service Commission, District 3 - Metro-Atlanta",253,12
Murray,Advance in Person,5111,"Public Service Commission, District 3 - Metro-Atlanta",4969,142
Murray,Election Day,5715,"Public Service Commission, District 3 - Metro-Atlanta",5556,159
Murray,Provisional,0,"Public Service Commission, District 3 - Metro-Atlanta",0,0
Muscogee,Absentee by Mail,4422,"Public Service Commission, District 3 - Metro-Atlanta",4351,71
Muscogee,Advance in Person,27700,"Public Service Commission, District 3 - Metro-Atlanta",27230,470
Muscogee,Election Day,31019,"Public Service Commission, District 3 - Metro-Atlanta",30395,624
Muscogee,Provisional,131,"Public Service Commission, District 3 - Metro-Atlanta",125,6
Newton,Absentee by Mail,2735,"Public Service Commission, District 3 - Metro-Atlanta",2693,42
Newton,Advance in Person,19236,"Public Service Commission, District 3 - Metro-Atlanta",18907,329
Newton,Election Day,21158,"Public Service Commission, District 3 - Metro-Atlanta",20763,395
Newton,Provisional,12,"Public Service Commission, District 3 - Metro-Atlanta",11,1
Oconee,Absentee by Mail,931,"Public Service Commission, District 3 - Metro-Atlanta",911,20
Oconee,Advance in Person,11688,"Public Service Commission, District 3 - Metro-Atlanta",11485,203
Oconee,Election Day,8114,"Public Service Commission, District 3 - Metro-Atlanta",7884,230
Oconee,Provisional,11,"Public Service Commission, District 3 - Metro-Atlanta",11,0
Oglethorpe,Absentee by Mail,409,"Public Service Commission, District 3 - Metro-Atlanta",403,6
Oglethorpe,Advance in Person,3417,"Public Service Commission, District 3 - Metro-Atlanta",3354,63
Oglethorpe,Election Day,2658,"Public Service Commission, District 3 - Metro-Atlanta",2572,86
Oglethorpe,Provisional,1,"Public Service Commission, District 3 - Metro-Atlanta",1,0
Paulding,Absentee by Mail,3307,"Public Service Commission, District 3 - Metro-Atlanta",3246,61
Paulding,Advance in Person,32842,"Public Service Commission, District 3 - Metro-Atlanta",32322,520
Paulding,Election Day,25073,"Public Service Commission, District 3 - Metro-Atlanta",24668,405
Paulding,Provisional,83,"Public Service Commission, District 3 - Metro-Atlanta",77,6
Peach,Absentee by Mail,445,"Public Service Commission, District 3 - Metro-Atlanta",436,9
Peach,Advance in Person,6720,"Public Service Commission, District 3 - Metro-Atlanta",6587,133
Peach,Election Day,3190,"Public Service Commission, District 3 - Metro-Atlanta",3122,68
Peach,Provisional,90,"Public Service Commission, District 3 - Metro-Atlanta",86,4
Pickens,Absentee by Mail,222,"Public Service Commission, District 3 - Metro-Atlanta",216,6
Pickens,Advance in Person,7121,"Public Service Commission, District 3 - Metro-Atlanta",6969,152
Pickens,Election Day,6019,"Public Service Commission, District 3 - Metro-Atlanta",5874,145
Pickens,Provisional,0,"Public Service Commission, District 3 - Metro-Atlanta",0,0
Pierce,Absentee by Mail,327,"Public Service Commission, District 3 - Metro-Atlanta",324,3
Pierce,Advance in Person,4598,"Public Service Commission, District 3 - Metro-Atlanta",4523,75
Pierce,Election Day,1958,"Public Service Commission, District 3 - Metro-Atlanta",1914,44
Pierce,Provisional,1,"Public Service Commission, District 3 - Metro-Atlanta",1,0
Pike,Absentee by Mail,304,"Public Service Commission, District 3 - Metro-Atlanta",301,3
Pike,Advance in Person,4478,"Public Service Commission, District 3 - Metro-Atlanta",4423,55
Pike,Election Day,3752,"Public Service Commission, District 3 - Metro-Atlanta",3677,75
Pike,Provisional,9,"Public Service Commission, District 3 - Metro-Atlanta",9,0
Polk,Absentee by Mail,447,"Public Service Commission, District 3 - Metro-Atlanta",442,5
Polk,Advance in Person,7744,"Public Service Commission, District 3 - Metro-Atlanta",7602,142
Polk,Election Day,4668,"Public Service Commission, District 3 - Metro-Atlanta",4551,117
Polk,Provisional,2,"Public Service Commission, District 3 - Metro-Atlanta",1,1
Pulaski,Absentee by Mail,232,"Public Service Commission, District 3 - Metro-Atlanta",220,12
Pulaski,Advance in Person,2522,"Public Service Commission, District 3 - Metro-Atlanta",2419,103
Pulaski,Election Day,868,"Public Service Commission, District 3 - Metro-Atlanta",821,47
Pulaski,Provisional,0,"Public Service Commission, District 3 - Metro-Atlanta",0,0
Putnam,Absentee by Mail,598,"Public Service Commission, District 3 - Metro-Atlanta",590,8
Putnam,Advance in Person,4858,"Public Service Commission, District 3 - Metro-Atlanta",4770,88
Putnam,Election Day,3865,"Public Service Commission, District 3 - Metro-Atlanta",3784,81
Putnam,Provisional,14,"Public Service Commission, District 3 - Metro-Atlanta",14,0
Quitman,Absentee by Mail,60,"Public Service Commission, District 3 - Metro-Atlanta",51,9
Quitman,Advance in Person,451,"Public Service Commission, District 3 - Metro-Atlanta",427,24
Quitman,Election Day,429,"Public Service Commission, District 3 - Metro-Atlanta",408,21
Quitman,Provisional,0,"Public Service Commission, District 3 - Metro-Atlanta",0,0
Rabun,Absentee by Mail,843,"Public Service Commission, District 3 - Metro-Atlanta",818,25
Rabun,Advance in Person,4889,"Public Service Commission, District 3 - Metro-Atlanta",4789,100
Rabun,Election Day,1846,"Public Service Commission, District 3 - Metro-Atlanta",1793,53
Rabun,Provisional,0,"Public Service Commission, District 3 - Metro-Atlanta",0,0
Randolph,Absentee by Mail,313,"Public Service Commission, District 3 - Metro-Atlanta",299,14
Randolph,Advance in Person,1232,"Public Service Commission, District 3 - Metro-Atlanta",1189,43
Randolph,Election Day,1243,"Public Service Commission, District 3 - Metro-Atlanta",1200,43
Randolph,Provisional,1,"Public Service Commission, District 3 - Metro-Atlanta",1,0
Richmond,Absentee by Mail,5314,"Public Service Commission, District 3 - Metro-Atlanta",5197,117
Richmond,Advance in Person,28737,"Public Service Commission, District 3 - Metro-Atlanta",28250,487
Richmond,Election Day,35992,"Public Service Commission, District 3 - Metro-Atlanta",35134,858
Richmond,Provisional,112,"Public Service Commission, District 3 - Metro-Atlanta",107,5
Rockdale,Absentee by Mail,1853,"Public Service Commission, District 3 - Metro-Atlanta",1829,24
Rockdale,Advance in Person,22789,"Public Service Commission, District 3 - Metro-Atlanta",22446,343
Rockdale,Election Day,11958,"Public Service Commission, District 3 - Metro-Atlanta",11759,199
Rockdale,Provisional,55,"Public Service Commission, District 3 - Metro-Atlanta",52,3
Schley,Absentee by Mail,96,"Public Service Commission, District 3 - Metro-Atlanta",96,0
Schley,Advance in Person,1321,"Public Service Commission, District 3 - Metro-Atlanta",1284,37
Schley,Election Day,514,"Public Service Commission, District 3 - Metro-Atlanta",494,20
Schley,Provisional,2,"Public Service Commission, District 3 - Metro-Atlanta",2,0
Screven,Absentee by Mail,271,"Public Service Commission, District 3 - Metro-Atlanta",266,5
Screven,Advance in Person,2674,"Public Service Commission, District 3 - Metro-Atlanta",2583,91
Screven,Election Day,2462,"Public Service Commission, District 3 - Metro-Atlanta",2390,72
Screven,Provisional,7,"Public Service Commission, District 3 - Metro-Atlanta",7,0
Seminole,Absentee by Mail,264,"Public Service Commission, District 3 - Metro-Atlanta",259,5
Seminole,Advance in Person,1078,"Public Service Commission, District 3 - Metro-Atlanta",1062,16
Seminole,Election Day,1872,"Public Service Commission, District 3 - Metro-Atlanta",1826,46
Seminole,Provisional,13,"Public Service Commission, District 3 - Metro-Atlanta",12,1
Spalding,Absentee by Mail,1283,"Public Service Commission, District 3 - Metro-Atlanta",1238,45
Spalding,Advance in Person,13046,"Public Service Commission, District 3 - Metro-Atlanta",12666,380
Spalding,Election Day,10056,"Public Service Commission, District 3 - Metro-Atlanta",9816,240
Spalding,Provisional,32,"Public Service Commission, District 3 - Metro-Atlanta",27,5
Stephens,Absentee by Mail,536,"Public Service Commission, District 3 - Metro-Atlanta",521,15
Stephens,Advance in Person,6139,"Public Service Commission, District 3 - Metro-Atlanta",6022,117
Stephens,Election Day,2394,"Public Service Commission, District 3 - Metro-Atlanta",2320,74
Stephens,Provisional,18,"Public Service Commission, District 3 - Metro-Atlanta",17,1
Stewart,Absentee by Mail,233,"Public Service Commission, District 3 - Metro-Atlanta",218,15
Stewart,Advance in Person,694,"Public Service Commission, District 3 - Metro-Atlanta",653,41
Stewart,Election Day,857,"Public Service Commission, District 3 - Metro-Atlanta",774,83
Stewart,Provisional,35,"Public Service Commission, District 3 - Metro-Atlanta",34,1
Sumter,Absentee by Mail,877,"Public Service Commission, District 3 - Metro-Atlanta",852,25
Sumter,Advance in Person,5531,"Public Service Commission, District 3 - Metro-Atlanta",5382,149
Sumter,Election Day,4148,"Public Service Commission, District 3 - Metro-Atlanta",4022,126
Sumter,Provisional,0,"Public Service Commission, District 3 - Metro-Atlanta",0,0
Talbot,Absentee by Mail,285,"Public Service Commission, District 3 - Metro-Atlanta",262,23
Talbot,Advance in Person,772,"Public Service Commission, District 3 - Metro-Atlanta",745,27
Talbot,Election Day,1895,"Public Service Commission, District 3 - Metro-Atlanta",1799,96
Talbot,Provisional,2,"Public Service Commission, District 3 - Metro-Atlanta",2,0
Taliaferro,Absentee by Mail,162,"Public Service Commission, District 3 - Metro-Atlanta",145,17
Taliaferro,Advance in Person,441,"Public Service Commission, District 3 - Metro-Atlanta",401,40
Taliaferro,Election Day,314,"Public Service Commission, District 3 - Metro-Atlanta",291,23
Taliaferro,Provisional,4,"Public Service Commission, District 3 - Metro-Atlanta",3,1
Tattnall,Absentee by Mail,392,"Public Service Commission, District 3 - Metro-Atlanta",387,5
Tattnall,Advance in Person,3539,"Public Service Commission, District 3 - Metro-Atlanta",3416,123
Tattnall,Election Day,2708,"Public Service Commission, District 3 - Metro-Atlanta",2614,94
Tattnall,Provisional,8,"Public Service Commission, District 3 - Metro-Atlanta",8,0
Taylor,Absentee by Mail,243,"Public Service Commission, District 3 - Metro-Atlanta",239,4
Taylor,Advance in Person,1843,"Public Service Commission, District 3 - Metro-Atlanta",1810,33
Taylor,Election Day,1179,"Public Service Commission, District 3 - Metro-Atlanta",1136,43
Taylor,Provisional,29,"Public Service Commission, District 3 - Metro-Atlanta",29,0
Telfair,Absentee by Mail,331,"Public Service Commission, District 3 - Metro-Atlanta",328,3
Telfair,Advance in Person,1676,"Public Service Commission, District 3 - Metro-Atlanta",1593,83
Telfair,Election Day,1624,"Public Service Commission, District 3 - Metro-Atlanta",1566,58
Telfair,Provisional,1,"Public Service Commission, District 3 - Metro-Atlanta",1,0
Terrell,Absentee by Mail,327,"Public Service Commission, District 3 - Metro-Atlanta",326,1
Terrell,Advance in Person,1612,"Public Service Commission, District 3 - Metro-Atlanta",1565,47
Terrell,Election Day,1991,"Public Service Commission, District 3 - Metro-Atlanta",1924,67
Terrell,Provisional,9,"Public Service Commission, District 3 - Metro-Atlanta",9,0
Thomas,Absentee by Mail,991,"Public Service Commission, District 3 - Metro-Atlanta",978,13
Thomas,Advance in Person,8376,"Public Service Commission, District 3 - Metro-Atlanta",8209,167
Thomas,Election Day,7874,"Public Service Commission, District 3 - Metro-Atlanta",7681,193
Thomas,Provisional,3,"Public Service Commission, District 3 - Metro-Atlanta",3,0
Tift,Absentee by Mail,561,"Public Service Commission, District 3 - Metro-Atlanta",552,9
Tift,Advance in Person,7646,"Public Service Commission, District 3 - Metro-Atlanta",7454,192
Tift,Election Day,5462,"Public Service Commission, District 3 - Metro-Atlanta",5297,165
Tift,Provisional,4,"Public Service Commission, District 3 - Metro-Atlanta",3,1
Toombs,Absentee by Mail,681,"Public Service Commission, District 3 - Metro-Atlanta",660,21
Toombs,Advance in Person,4860,"Public Service Commission, District 3 - Metro-Atlanta",4715,145
Toombs,Election Day,3310,"Public Service Commission, District 3 - Metro-Atlanta",3210,100
Toombs,Provisional,9,"Public Service Commission, District 3 - Metro-Atlanta",9,0
Towns,Absentee by Mail,284,"Public Service Commission, District 3 - Metro-Atlanta",275,9
Towns,Advance in Person,4009,"Public Service Commission, District 3 - Metro-Atlanta",3893,116
Towns,Election Day,1839,"Public Service Commission, District 3 - Metro-Atlanta",1793,46
Towns,Provisional,0,"Public Service Commission, District 3 - Metro-Atlanta",0,0
Treutlen,Absentee by Mail,146,"Public Service Commission, District 3 - Metro-Atlanta",135,11
Treutlen,Advance in Person,1659,"Public Service Commission, District 3 - Metro-Atlanta",1594,65
Treutlen,Election Day,805,"Public Service Commission, District 3 - Metro-Atlanta",772,33
Treutlen,Provisional,4,"Public Service Commission, District 3 - Metro-Atlanta",4,0
Troup,Absentee by Mail,1264,"Public Service Commission, District 3 - Metro-Atlanta",1233,31
Troup,Advance in Person,11226,"Public Service Commission, District 3 - Metro-Atlanta",11028,198
Troup,Election Day,11173,"Public Service Commission, District 3 - Metro-Atlanta",10898,275
Troup,Provisional,250,"Public Service Commission, District 3 - Metro-Atlanta",241,9
Turner,Absentee by Mail,148,"Public Service Commission, District 3 - Metro-Atlanta",147,1
Turner,Advance in Person,1922,"Public Service Commission, District 3 - Metro-Atlanta",1853,69
Turner,Election Day,1199,"Public Service Commission, District 3 - Metro-Atlanta",1168,31
Turner,Provisional,5,"Public Service Commission, District 3 - Metro-Atlanta",5,0
Twiggs,Absentee by Mail,275,"Public Service Commission, District 3 - Metro-Atlanta",271,4
Twiggs,Advance in Person,1531,"Public Service Commission, District 3 - Metro-Atlanta",1489,42
Twiggs,Election Day,1981,"Public Service Commission, District 3 - Metro-Atlanta",1906,75
Twiggs,Provisional,5,"Public Service Commission, District 3 - Metro-Atlanta",5,0
Union,Absentee by Mail,482,"Public Service Commission, District 3 - Metro-Atlanta",469,13
Union,Advance in Person,6626,"Public Service Commission, District 3 - Metro-Atlanta",6512,114
Union,Election Day,4755,"Public Service Commission, District 3 - Metro-Atlanta",4610,145
Union,Provisional,2,"Public Service Commission, District 3 - Metro-Atlanta",2,0
Upson,Absentee by Mail,602,"Public Service Commission, District 3 - Metro-Atlanta",591,11
Upson,Advance in Person,6729,"Public Service Commission, District 3 - Metro-Atlanta",6589,140
Upson,Election Day,3227,"Public Service Commission, District 3 - Metro-Atlanta",3158,69
Upson,Provisional,10,"Public Service Commission, District 3 - Metro-Atlanta",10,0
Walker,Absentee by Mail,813,"Public Service Commission, District 3 - Metro-Atlanta",795,18
Walker,Advance in Person,11133,"Public Service Commission, District 3 - Metro-Atlanta",10930,203
Walker,Election Day,9505,"Public Service Commission, District 3 - Metro-Atlanta",9287,218
Walker,Provisional,39,"Public Service Commission, District 3 - Metro-Atlanta",38,1
Walton,Absentee by Mail,1769,"Public Service Commission, District 3 - Metro-Atlanta",1741,28
Walton,Advance in Person,14370,"Public Service Commission, District 3 - Metro-Atlanta",14127,243
Walton,Election Day,22496,"Public Service Commission, District 3 - Metro-Atlanta",22078,418
Walton,Provisional,51,"Public Service Commission, District 3 - Metro-Atlanta",50,1
Ware,Absentee by Mail,627,"Public Service Commission, District 3 - Metro-Atlanta",600,27
Ware,Advance in Person,5460,"Public Service Commission, District 3 - Metro-Atlanta",5398,62
Ware,Election Day,4917,"Public Service Commission, District 3 - Metro-Atlanta",4800,117
Ware,Provisional,12,"Public Service Commission, District 3 - Metro-Atlanta",11,1
Warren,Absentee by Mail,187,"Public Service Commission, District 3 - Metro-Atlanta",183,4
Warren,Advance in Person,1267,"Public Service Commission, District 3 - Metro-Atlanta",1218,49
Warren,Election Day,806,"Public Service Commission, District 3 - Metro-Atlanta",778,28
Warren,Provisional,1,"Public Service Commission, District 3 - Metro-Atlanta",1,0
Washington,Absentee by Mail,727,"Public Service Commission, District 3 - Metro-Atlanta",702,25
Washington,Advance in Person,3907,"Public Service Commission, District 3 - Metro-Atlanta",3757,150
Washington,Election Day,3525,"Public Service Commission, District 3 - Metro-Atlanta",3364,161
Washington,Provisional,10,"Public Service Commission, District 3 - Metro-Atlanta",10,0
Wayne,Absentee by Mail,501,"Public Service Commission, District 3 - Metro-Atlanta",488,13
Wayne,Advance in Person,5868,"Public Service Commission, District 3 - Metro-Atlanta",5711,157
Wayne,Election Day,3753,"Public Service Commission, District 3 - Metro-Atlanta",3649,104
Wayne,Provisional,10,"Public Service Commission, District 3 - Metro-Atlanta",9,1
Webster,Absentee by Mail,152,"Public Service Commission, District 3 - Metro-Atlanta",146,6
Webster,Advance in Person,544,"Public Service Commission, District 3 - Metro-Atlanta",528,16
Webster,Election Day,404,"Public Service Commission, District 3 - Metro-Atlanta",388,16
Webster,Provisional,0,"Public Service Commission, District 3 - Metro-Atlanta",0,0
Wheeler,Absentee by Mail,115,"Public Service Commission, District 3 - Metro-Atlanta",115,0
Wheeler,Advance in Person,974,"Public Service Commission, District 3 - Metro-Atlanta",950,24
Wheeler,Election Day,838,"Public Service Commission, District 3 - Metro-Atlanta",816,22
Wheeler,Provisional,4,"Public Service Commission, District 3 - Metro-Atlanta",3,1
White,Absentee by Mail,537,"Public Service Commission, District 3 - Metro-Atlanta",530,7
White,Advance in Person,5408,"Public Service Commission, District 3 - Metro-Atlanta",5314,94
White,Election Day,5489,"Public Service Commission, District 3 - Metro-Atlanta",5401,88
White,Provisional,6,"Public Service Commission, District 3 - Metro-Atlanta",6,0
Whitfield,Absentee by Mail,1017,"Public Service Commission, District 3 - Metro-Atlanta",998,19
Whitfield,Advance in Person,9610,"Public Service Commission, District 3 - Metro-Atlanta",9425,185
Whitfield,Election Day,16675,"Public Service Commission, District 3 - Metro-Atlanta",16238,437
Whitfield,Provisional,25,"Public Service Commission, District 3 - Metro-Atlanta",23,2
Wilcox,Absentee by Mail,205,"Public Service Commission, District 3 - Metro-Atlanta",200,5
Wilcox,Advance in Person,1202,"Public Service Commission, District 3 - Metro-Atlanta",1175,27
Wilcox,Election Day,1408,"Public Service Commission, District 3 - Metro-Atlanta",1361,47
Wilcox,Provisional,0,"Public Service Commission, District 3 - Metro-Atlanta",0,0
Wilkes,Absentee by Mail,301,"Public Service Commission, District 3 - Metro-Atlanta",292,9
Wilkes,Advance in Person,2075,"Public Service Commission, District 3 - Metro-Atlanta",2010,65
Wilkes,Election Day,1995,"Public Service Commission, District 3 - Metro-Atlanta",1923,72
Wilkes,Provisional,6,"Public Service Commission, District 3 - Metro-Atlanta",6,0
Wilkinson,Absentee by Mail,270,"Public Service Commission, District 3 - Metro-Atlanta",263,7
Wilkinson,Advance in Person,1567,"Public Service Commission, District 3 - Metro-Atlanta",1512,55
Wilkinson,Election Day,2427,"Public Service Commission, District 3 - Metro-Atlanta",2324,103
Wilkinson,Provisional,1,"Public Service Commission, District 3 - Metro-Atlanta",1,0
Worth,Absentee by Mail,305,"Public Service Commission, District 3 - Metro-Atlanta",299,6
Worth,Advance in Person,3108,"Public Service Commission, District 3 - Metro-Atlanta",3051,57
Worth,Election Day,4418,"Public Service Commission, District 3 - Metro-Atlanta",4302,116
Worth,Provisional,15,"Public Service Commission, District 3 - Metro-Atlanta",15,0
Appling,Absentee by Mail,530,"Public Service Commission, District 5 - Western",514,16
Appling,Advance in Person,3298,"Public Service Commission, District 5 - Western",3191,107
Appling,Election Day,2978,"Public Service Commission, District 5 - Western",2875,103
Appling,Provisional,3,"Public Service Commission, District 5 - Western",3,0
Atkinson,Absentee by Mail,88,"Public Service Commission, District 5 - Western",88,0
Atkinson,Advance in Person,1285,"Public Service Commission, District 5 - Western",1218,67
Atkinson,Election Day,1147,"Public Service Commission, District 5 - Western",1082,65
Atkinson,Provisional,2,"Public Service Commission, District 5 - Western",1,1
Bacon,Absentee by Mail,174,"Public Service Commission, District 5 - Western",171,3
Bacon,Advance in Person,2828,"Public Service Commission, District 5 - Western",2757,71
Bacon,Election Day,827,"Public Service Commission, District 5 - Western",783,44
Bacon,Provisional,1,"Public Service Commission, District 5 - Western",1,0
Baker,Absentee by Mail,141,"Public Service Commission, District 5 - Western",133,8
Baker,Advance in Person,485,"Public Service Commission, District 5 - Western",467,18
Baker,Election Day,665,"Public Service Commission, District 5 - Western",622,43
Baker,Provisional,2,"Public Service Commission, District 5 - Western",2,0
Baldwin,Absentee by Mail,1158,"Public Service Commission, District 5 - Western",1139,19
Baldwin,Advance in Person,8295,"Public Service Commission, District 5 - Western",8066,229
Baldwin,Election Day,6180,"Public Service Commission, District 5 - Western",5976,204
Baldwin,Provisional,3,"Public Service Commission, District 5 - Western",3,0
Banks,Absentee by Mail,223,"Public Service Commission, District 5 - Western",220,3
Banks,Advance in Person,2771,"Public Service Commission, District 5 - Western",2724,47
Banks,Election Day,3858,"Public Service Commission, District 5 - Western",3781,77
Banks,Provisional,1,"Public Service Commission, District 5 - Western",1,0
Barrow,Absentee by Mail,1263,"Public Service Commission, District 5 - Western",1235,28
Barrow,Advance in Person,12223,"Public Service Commission, District 5 - Western",12037,186
Barrow,Election Day,13912,"Public Service Commission, District 5 - Western",13649,263
Barrow,Provisional,7,"Public Service Commission, District 5 - Western",7,0
Bartow,Absentee by Mail,1568,"Public Service Commission, District 5 - Western",1548,20
Bartow,Advance in Person,16175,"Public Service Commission, District 5 - Western",15916,259
Bartow,Election Day,19584,"Public Service Commission, District 5 - Western",19197,387
Bartow,Provisional,32,"Public Service Commission, District 5 - Western",32,0
Ben Hill,Absentee by Mail,320,"Public Service Commission, District 5 - Western",313,7
Ben Hill,Advance in Person,3605,"Public Service Commission, District 5 - Western",3550,55
Ben Hill,Election Day,1608,"Public Service Commission, District 5 - Western",1561,47
Ben Hill,Provisional,14,"Public Service Commission, District 5 - Western",13,1
Berrien,Absentee by Mail,322,"Public Service Commission, District 5 - Western",318,4
Berrien,Advance in Person,3153,"Public Service Commission, District 5 - Western",3083,70
Berrien,Election Day,2772,"Public Service Commission, District 5 - Western",2698,74
Berrien,Provisional,5,"Public Service Commission, District 5 - Western",4,1
Bibb,Absentee by Mail,4461,"Public Service Commission, District 5 - Western",4396,65
Bibb,Advance in Person,26183,"Public Service Commission, District 5 - Western",25650,533
Bibb,Election Day,29816,"Public Service Commission, District 5 - Western",29110,706
Bibb,Provisional,232,"Public Service Commission, District 5 - Western",227,5
Bleckley,Absentee by Mail,257,"Public Service Commission, District 5 - Western",249,8
Bleckley,Advance in Person,2805,"Public Service Commission, District 5 - Western",2722,83
Bleckley,Election Day,1793,"Public Service Commission, District 5 - Western",1728,65
Bleckley,Provisional,5,"Public Service Commission, District 5 - Western",5,0
Brantley,Absentee by Mail,188,"Public Service Commission, District 5 - Western",184,4
Brantley,Advance in Person,2868,"Public Service Commission, District 5 - Western",2807,61
Brantley,Election Day,2633,"Public Service Commission, District 5 - Western",2534,99
Brantley,Provisional,5,"Public Service Commission, District 5 - Western",5,0
Brooks,Absentee by Mail,465,"Public Service Commission, District 5 - Western",453,12
Brooks,Advance in Person,2417,"Public Service Commission, District 5 - Western",2360,57
Brooks,Election Day,2814,"Public Service Commission, District 5 - Western",2739,75
Brooks,Provisional,27,"Public Service Commission, District 5 - Western",26,1
Bryan,Absentee by Mail,582,"Public Service Commission, District 5 - Western",571,11
Bryan,Advance in Person,8342,"Public Service Commission, District 5 - Western",8199,143
Bryan,Election Day,6046,"Public Service Commission, District 5 - Western",5924,122
Bryan,Provisional,15,"Public Service Commission, District 5 - Western",15,0
Bulloch,Absentee by Mail,1076,"Public Service Commission, District 5 - Western",1050,26
Bulloch,Advance in Person,11170,"Public Service Commission, District 5 - Western",10924,246
Bulloch,Election Day,11297,"Public Service Commission, District 5 - Western",10998,299
Bulloch,Provisional,140,"Public Service Commission, District 5 - Western",137,3
Burke,Absentee by Mail,968,"Public Service Commission, District 5 - Western",951,17
Burke,Advance in Person,3199,"Public Service Commission, District 5 - Western",3138,61
Burke,Election Day,4552,"Public Service Commission, District 5 - Western",4416,136
Burke,Provisional,2,"Public Service Commission, District 5 - Western",2,0
Butts,Absentee by Mail,380,"Public Service Commission, District 5 - Western",370,10
Butts,Advance in Person,6277,"Public Service Commission, District 5 - Western",6153,124
Butts,Election Day,2206,"Public Service Commission, District 5 - Western",2159,47
Butts,Provisional,0,"Public Service Commission, District 5 - Western",0,0
Calhoun,Absentee by Mail,185,"Public Service Commission, District 5 - Western",181,4
Calhoun,Advance in Person,607,"Public Service Commission, District 5 - Western",597,10
Calhoun,Election Day,1107,"Public Service Commission, District 5 - Western",1075,32
Calhoun,Provisional,0,"Public Service Commission, District 5 - Western",0,0
Camden,Absentee by Mail,1193,"Public Service Commission, District 5 - Western",1174,19
Camden,Advance in Person,8085,"Public Service Commission, District 5 - Western",7967,118
Camden,Election Day,7775,"Public Service Commission, District 5 - Western",7593,182
Camden,Provisional,8,"Public Service Commission, District 5 - Western",8,0
Candler,Absentee by Mail,120,"Public Service Commission, District 5 - Western",117,3
Candler,Advance in Person,2335,"Public Service Commission, District 5 - Western",2273,62
Candler,Election Day,1083,"Public Service Commission, District 5 - Western",1051,32
Candler,Provisional,1,"Public Service Commission, District 5 - Western",1,0
Carroll,Absentee by Mail,1518,"Public Service Commission, District 5 - Western",1481,37
Carroll,Advance in Person,20100,"Public Service Commission, District 5 - Western",19807,293
Carroll,Election Day,20121,"Public Service Commission, District 5 - Western",19717,404
Carroll,Provisional,104,"Public Service Commission, District 5 - Western",100,4
Catoosa,Absentee by Mail,540,"Public Service Commission, District 5 - Western",530,10
Catoosa,Advance in Person,13673,"Public Service Commission, District 5 - Western",13416,257
Catoosa,Election Day,9512,"Public Service Commission, District 5 - Western",9325,187
Catoosa,Provisional,33,"Public Service Commission, District 5 - Western",33,0
Charlton,Absentee by Mail,163,"Public Service Commission, District 5 - Western",157,6
Charlton,Advance in Person,1549,"Public Service Commission, District 5 - Western",1512,37
Charlton,Election Day,1657,"Public Service Commission, District 5 - Western",1601,56
Charlton,Provisional,8,"Public Service Commission, District 5 - Western",7,1
Chatham,Absentee by Mail,6177,"Public Service Commission, District 5 - Western",6026,151
Chatham,Advance in Person,32338,"Public Service Commission, District 5 - Western",31771,567
Chatham,Election Day,64823,"Public Service Commission, District 5 - Western",63235,1588
Chatham,Provisional,205,"Public Service Commission, District 5 - Western",198,7
Chattahoochee,Absentee by Mail,35,"Public Service Commission, District 5 - Western",35,0
Chattahoochee,Advance in Person,493,"Public Service Commission, District 5 - Western",477,16
Chattahoochee,Election Day,574,"Public Service Commission, District 5 - Western",555,19
Chattahoochee,Provisional,3,"Public Service Commission, District 5 - Western",3,0
Chattooga,Absentee by Mail,225,"Public Service Commission, District 5 - Western",221,4
Chattooga,Advance in Person,3452,"Public Service Commission, District 5 - Western",3367,85
Chattooga,Election Day,3750,"Public Service Commission, District 5 - Western",3640,110
Chattooga,Provisional,7,"Public Service Commission, District 5 - Western",7,0
Cherokee,Absentee by Mail,5312,"Public Service Commission, District 5 - Western",5201,111
Cherokee,Advance in Person,48565,"Public Service Commission, District 5 - Western",47878,687
Cherokee,Election Day,52422,"Public Service Commission, District 5 - Western",51229,1193
Cherokee,Provisional,112,"Public Service Commission, District 5 - Western",108,4
Clarke,Absentee by Mail,3022,"Public Service Commission, District 5 - Western",2961,61
Clarke,Advance in Person,19957,"Public Service Commission, District 5 - Western",19579,378
Clarke,Election Day,20282,"Public Service Commission, District 5 - Western",19664,618
Clarke,Provisional,41,"Public Service Commission, District 5 - Western",40,1
Clay,Absentee by Mail,143,"Public Service Commission, District 5 - Western",135,8
Clay,Advance in Person,579,"Public Service Commission, District 5 - Western",560,19
Clay,Election Day,464,"Public Service Commission, District 5 - Western",448,16
Clay,Provisional,0,"Public Service Commission, District 5 - Western",0,0
Clayton,Absentee by Mail,5847,"Public Service Commission, District 5 - Western",5720,127
Clayton,Advance in Person,47671,"Public Service Commission, District 5 - Western",46958,713
Clayton,Election Day,38322,"Public Service Commission, District 5 - Western",37562,760
Clayton,Provisional,372,"Public Service Commission, District 5 - Western",348,24
Clinch,Absentee by Mail,109,"Public Service Commission, District 5 - Western",107,2
Clinch,Advance in Person,1236,"Public Service Commission, District 5 - Western",1179,57
Clinch,Election Day,909,"Public Service Commission, District 5 - Western",871,38
Clinch,Provisional,4,"Public Service Commission, District 5 - Western",4,0
Cobb,Absentee by Mail,25901,"Public Service Commission, District 5 - Western",25303,598
Cobb,Advance in Person,111554,"Public Service Commission, District 5 - Western",110149,1405
Cobb,Election Day,172926,"Public Service Commission, District 5 - Western",169540,3386
Cobb,Provisional,1433,"Public Service Commission, District 5 - Western",1384,49
Coffee,Absentee by Mail,395,"Public Service Commission, District 5 - Western",389,6
Coffee,Advance in Person,7664,"Public Service Commission, District 5 - Western",7445,219
Coffee,Election Day,4536,"Public Service Commission, District 5 - Western",4377,159
Coffee,Provisional,20,"Public Service Commission, District 5 - Western",19,1
Colquitt,Absentee by Mail,514,"Public Service Commission, District 5 - Western",501,13
Colquitt,Advance in Person,6071,"Public Service Commission, District 5 - Western",5904,167
Colquitt,Election Day,6368,"Public Service Commission, District 5 - Western",6122,246
Colquitt,Provisional,10,"Public Service Commission, District 5 - Western",10,0
Columbia,Absentee by Mail,2936,"Public Service Commission, District 5 - Western",2884,52
Columbia,Advance in Person,29686,"Public Service Commission, District 5 - Western",29330,356
Columbia,Election Day,28969,"Public Service Commission, District 5 - Western",28414,555
Columbia,Provisional,43,"Public Service Commission, District 5 - Western",43,0
Cook,Absentee by Mail,244,"Public Service Commission, District 5 - Western",242,2
Cook,Advance in Person,3069,"Public Service Commission, District 5 - Western",3005,64
Cook,Election Day,2490,"Public Service Commission, District 5 - Western",2437,53
Cook,Provisional,0,"Public Service Commission, District 5 - Western",0,0
Coweta,Absentee by Mail,2812,"Public Service Commission, District 5 - Western",2751,61
Coweta,Advance in Person,25641,"Public Service Commission, District 5 - Western",25252,389
Coweta,Election Day,29603,"Public Service Commission, District 5 - Western",29005,598
Coweta,Provisional,15,"Public Service Commission, District 5 - Western",15,0
Crawford,Absentee by Mail,234,"Public Service Commission, District 5 - Western",229,5
Crawford,Advance in Person,2567,"Public Service Commission, District 5 - Western",2483,84
Crawford,Election Day,2130,"Public Service Commission, District 5 - Western",2083,47
Crawford,Provisional,3,"Public Service Commission, District 5 - Western",3,0
Crisp,Absentee by Mail,363,"Public Service Commission, District 5 - Western",348,15
Crisp,Advance in Person,4191,"Public Service Commission, District 5 - Western",4071,120
Crisp,Election Day,2470,"Public Service Commission, District 5 - Western",2340,130
Crisp,Provisional,26,"Public Service Commission, District 5 - Western",22,4
Dade,Absentee by Mail,129,"Public Service Commission, District 5 - Western",117,12
Dade,Advance in Person,2561,"Public Service Commission, District 5 - Western",2478,83
Dade,Election Day,2760,"Public Service Commission, District 5 - Western",2668,92
Dade,Provisional,12,"Public Service Commission, District 5 - Western",12,0
Dawson,Absentee by Mail,439,"Public Service Commission, District 5 - Western",437,2
Dawson,Advance in Person,7020,"Public Service Commission, District 5 - Western",6914,106
Dawson,Election Day,4111,"Public Service Commission, District 5 - Western",4026,85
Dawson,Provisional,11,"Public Service Commission, District 5 - Western",11,0
DeKalb,Absentee by Mail,19672,"Public Service Commission, District 5 - Western",19194,478
DeKalb,Advance in Person,150814,"Public Service Commission, District 5 - Western",148081,2733
DeKalb,Election Day,140482,"Public Service Commission, District 5 - Western",136641,3841
DeKalb,Provisional,1773,"Public Service Commission, District 5 - Western",1713,60
Decatur,Absentee by Mail,548,"Public Service Commission, District 5 - Western",539,9
Decatur,Advance in Person,4260,"Public Service Commission, District 5 - Western",4167,93
Decatur,Election Day,4235,"Public Service Commission, District 5 - Western",4134,101
Decatur,Provisional,103,"Public Service Commission, District 5 - Western",98,5
Dodge,Absentee by Mail,448,"Public Service Commission, District 5 - Western",436,12
Dodge,Advance in Person,3411,"Public Service Commission, District 5 - Western",3275,136
Dodge,Election Day,3192,"Public Service Commission, District 5 - Western",3024,168
Dodge,Provisional,10,"Public Service Commission, District 5 - Western",10,0
Dooly,Absentee by Mail,196,"Public Service Commission, District 5 - Western",187,9
Dooly,Advance in Person,1889,"Public Service Commission, District 5 - Western",1804,85
Dooly,Election Day,1708,"Public Service Commission, District 5 - Western",1632,76
Dooly,Provisional,2,"Public Service Commission, District 5 - Western",1,1
Dougherty,Absentee by Mail,1944,"Public Service Commission, District 5 - Western",1895,49
Dougherty,Advance in Person,11332,"Public Service Commission, District 5 - Western",11131,201
Dougherty,Election Day,18021,"Public Service Commission, District 5 - Western",17584,437
Dougherty,Provisional,128,"Public Service Commission, District 5 - Western",119,9
Douglas,Absentee by Mail,3233,"Public Service Commission, District 5 - Western",3178,55
Douglas,Advance in Person,30219,"Public Service Commission, District 5 - Western",29859,360
Douglas,Election Day,21745,"Public Service Commission, District 5 - Western",21420,325
Douglas,Provisional,58,"Public Service Commission, District 5 - Western",58,0
Early,Absentee by Mail,473,"Public Service Commission, District 5 - Western",457,16
Early,Advance in Person,1569,"Public Service Commission, District 5 - Western",1537,32
Early,Election Day,2089,"Public Service Commission, District 5 - Western",2036,53
Early,Provisional,4,"Public Service Commission, District 5 - Western",2,2
Echols,Absentee by Mail,35,"Public Service Commission, District 5 - Western",35,0
Echols,Advance in Person,767,"Public Service Commission, District 5 - Western",747,20
Echols,Election Day,341,"Public Service Commission, District 5 - Western",325,16
Echols,Provisional,0,"Public Service Commission, District 5 - Western",0,0
Effingham,Absentee by Mail,750,"Public Service Commission, District 5 - Western",732,18
Effingham,Advance in Person,10717,"Public Service Commission, District 5 - Western",10532,185
Effingham,Election Day,11898,"Public Service Commission, District 5 - Western",11680,218
Effingham,Provisional,6,"Public Service Commission, District 5 - Western",6,0
Elbert,Absentee by Mail,563,"Public Service Commission, District 5 - Western",557,6
Elbert,Advance in Person,3722,"Public Service Commission, District 5 - Western",3603,119
Elbert,Election Day,3034,"Public Service Commission, District 5 - Western",2933,101
Elbert,Provisional,69,"Public Service Commission, District 5 - Western",67,2
Emanuel,Absentee by Mail,390,"Public Service Commission, District 5 - Western",377,13
Emanuel,Advance in Person,3424,"Public Service Commission, District 5 - Western",3324,100
Emanuel,Election Day,3896,"Public Service Commission, District 5 - Western",3723,173
Emanuel,Provisional,6,"Public Service Commission, District 5 - Western",6,0
Evans,Absentee by Mail,199,"Public Service Commission, District 5 - Western",194,5
Evans,Advance in Person,2162,"Public Service Commission, District 5 - Western",2073,89
Evans,Election Day,1086,"Public Service Commission, District 5 - Western",1040,46
Evans,Provisional,0,"Public Service Commission, District 5 - Western",0,0
Fannin,Absentee by Mail,658,"Public Service Commission, District 5 - Western",641,17
Fannin,Advance in Person,5341,"Public Service Commission, District 5 - Western",5235,106
Fannin,Election Day,5204,"Public Service Commission, District 5 - Western",5033,171
Fannin,Provisional,16,"Public Service Commission, District 5 - Western",16,0
Fayette,Absentee by Mail,2647,"Public Service Commission, District 5 - Western",2581,66
Fayette,Advance in Person,31073,"Public Service Commission, District 5 - Western",30673,400
Fayette,Election Day,24242,"Public Service Commission, District 5 - Western",23690,552
Fayette,Provisional,36,"Public Service Commission, District 5 - Western",34,2
Floyd,Absentee by Mail,1260,"Public Service Commission, District 5 - Western",1230,30
Floyd,Advance in Person,13688,"Public Service Commission, District 5 - Western",13434,254
Floyd,Election Day,15277,"Public Service Commission, District 5 - Western",14890,387
Floyd,Provisional,113,"Public Service Commission, District 5 - Western",106,7
Forsyth,Absentee by Mail,4428,"Public Service Commission, District 5 - Western",4305,123
Forsyth,Advance in Person,52559,"Public Service Commission, District 5 - Western",51825,734
Forsyth,Election Day,36252,"Public Service Commission, District 5 - Western",35453,799
Forsyth,Provisional,59,"Public Service Commission, District 5 - Western",59,0
Franklin,Absentee by Mail,388,"Public Service Commission, District 5 - Western",383,5
Franklin,Advance in Person,3502,"Public Service Commission, District 5 - Western",3450,52
Franklin,Election Day,4259,"Public Service Commission, District 5 - Western",4167,92
Franklin,Provisional,0,"Public Service Commission, District 5 - Western",0,0
Fulton,Absentee by Mail,17842,"Public Service Commission, District 5 - Western",17190,652
Fulton,Advance in Person,224522,"Public Service Commission, District 5 - Western",219997,4525
Fulton,Election Day,179442,"Public Service Commission, District 5 - Western",174221,5221
Fulton,Provisional,1982,"Public Service Commission, District 5 - Western",1863,119
Gilmer,Absentee by Mail,559,"Public Service Commission, District 5 - Western",549,10
Gilmer,Advance in Person,6295,"Public Service Commission, District 5 - Western",6159,136
Gilmer,Election Day,5617,"Public Service Commission, District 5 - Western",5452,165
Gilmer,Provisional,39,"Public Service Commission, District 5 - Western",36,3
Glascock,Absentee by Mail,81,"Public Service Commission, District 5 - Western",79,2
Glascock,Advance in Person,652,"Public Service Commission, District 5 - Western",624,28
Glascock,Election Day,567,"Public Service Commission, District 5 - Western",530,37
Glascock,Provisional,1,"Public Service Commission, District 5 - Western",1,0
Glynn,Absentee by Mail,1812,"Public Service Commission, District 5 - Western",1781,31
Glynn,Advance in Person,17510,"Public Service Commission, District 5 - Western",17214,296
Glynn,Election Day,13179,"Public Service Commission, District 5 - Western",12857,322
Glynn,Provisional,147,"Public Service Commission, District 5 - Western",139,8
Gordon,Absentee by Mail,547,"Public Service Commission, District 5 - Western",526,21
Gordon,Advance in Person,8119,"Public Service Commission, District 5 - Western",7917,202
Gordon,Election Day,9106,"Public Service Commission, District 5 - Western",8844,262
Gordon,Provisional,32,"Public Service Commission, District 5 - Western",31,1
Grady,Absentee by Mail,400,"Public Service Commission, District 5 - Western",391,9
Grady,Advance in Person,3857,"Public Service Commission, District 5 - Western",3794,63
Grady,Election Day,4099,"Public Service Commission, District 5 - Western",4002,97
Grady,Provisional,14,"Public Service Commission, District 5 - Western",13,1
Greene,Absentee by Mail,623,"Public Service Commission, District 5 - Western",606,17
Greene,Advance in Person,5593,"Public Service Commission, District 5 - Western",5515,78
Greene,Election Day,2773,"Public Service Commission, District 5 - Western",2707,66
Greene,Provisional,6,"Public Service Commission, District 5 - Western",6,0
Gwinnett,Absentee by Mail,20397,"Public Service Commission, District 5 - Western",20055,342
Gwinnett,Advance in Person,137166,"Public Service Commission, District 5 - Western",135422,1744
Gwinnett,Election Day,155146,"Public Service Commission, District 5 - Western",152061,3085
Gwinnett,Provisional,2209,"Public Service Commission, District 5 - Western",2149,60
Habersham,Absentee by Mail,853,"Public Service Commission, District 5 - Western",833,20
Habersham,Advance in Person,10023,"Public Service Commission, District 5 - Western",9816,207
Habersham,Election Day,4619,"Public Service Commission, District 5 - Western",4488,131
Habersham,Provisional,5,"Public Service Commission, District 5 - Western",5,0
Hall,Absentee by Mail,3493,"Public Service Commission, District 5 - Western",3421,72
Hall,Advance in Person,24348,"Public Service Commission, District 5 - Western",23935,413
Hall,Election Day,39441,"Public Service Commission, District 5 - Western",38582,859
Hall,Provisional,124,"Public Service Commission, District 5 - Western",116,8
Hancock,Absentee by Mail,490,"Public Service Commission, District 5 - Western",474,16
Hancock,Advance in Person,1531,"Public Service Commission, District 5 - Western",1463,68
Hancock,Election Day,1518,"Public Service Commission, District 5 - Western",1435,83
Hancock,Provisional,9,"Public Service Commission, District 5 - Western",8,1
Haralson,Absentee by Mail,393,"Public Service Commission, District 5 - Western",385,8
Haralson,Advance in Person,4202,"Public Service Commission, District 5 - Western",4113,89
Haralson,Election Day,5990,"Public Service Commission, District 5 - Western",5873,117
Haralson,Provisional,0,"Public Service Commission, District 5 - Western",0,0
Harris,Absentee by Mail,729,"Public Service Commission, District 5 - Western",711,18
Harris,Advance in Person,7251,"Public Service Commission, District 5 - Western",7155,96
Harris,Election Day,7992,"Public Service Commission, District 5 - Western",7814,178
Harris,Provisional,14,"Public Service Commission, District 5 - Western",14,0
Hart,Absentee by Mail,440,"Public Service Commission, District 5 - Western",432,8
Hart,Advance in Person,5220,"Public Service Commission, District 5 - Western",5068,152
Hart,Election Day,3958,"Public Service Commission, District 5 - Western",3834,124
Hart,Provisional,4,"Public Service Commission, District 5 - Western",4,0
Heard,Absentee by Mail,278,"Public Service Commission, District 5 - Western",274,4
Heard,Advance in Person,1427,"Public Service Commission, District 5 - Western",1394,33
Heard,Election Day,2346,"Public Service Commission, District 5 - Western",2292,54
Heard,Provisional,4,"Public Service Commission, District 5 - Western",4,0
Henry,Absentee by Mail,4997,"Public Service Commission, District 5 - Western",4868,129
Henry,Advance in Person,58658,"Public Service Commission, District 5 - Western",57885,773
Henry,Election Day,34710,"Public Service Commission, District 5 - Western",34114,596
Henry,Provisional,193,"Public Service Commission, District 5 - Western",182,11
Houston,Absentee by Mail,3190,"Public Service Commission, District 5 - Western",3131,59
Houston,Advance in Person,34816,"Public Service Commission, District 5 - Western",34347,469
Houston,Election Day,21152,"Public Service Commission, District 5 - Western",20764,388
Houston,Provisional,74,"Public Service Commission, District 5 - Western",69,5
Irwin,Absentee by Mail,133,"Public Service Commission, District 5 - Western",132,1
Irwin,Advance in Person,2048,"Public Service Commission, District 5 - Western",1995,53
Irwin,Election Day,1375,"Public Service Commission, District 5 - Western",1340,35
Irwin,Provisional,8,"Public Service Commission, District 5 - Western",8,0
Jackson,Absentee by Mail,1019,"Public Service Commission, District 5 - Western",1003,16
Jackson,Advance in Person,14919,"Public Service Commission, District 5 - Western",14690,229
Jackson,Election Day,10951,"Public Service Commission, District 5 - Western",10738,213
Jackson,Provisional,10,"Public Service Commission, District 5 - Western",9,1
Jasper,Absentee by Mail,421,"Public Service Commission, District 5 - Western",412,9
Jasper,Advance in Person,2981,"Public Service Commission, District 5 - Western",2928,53
Jasper,Election Day,2505,"Public Service Commission, District 5 - Western",2456,49
Jasper,Provisional,38,"Public Service Commission, District 5 - Western",37,1
Jeff Davis,Absentee by Mail,229,"Public Service Commission, District 5 - Western",222,7
Jeff Davis,Advance in Person,2680,"Public Service Commission, District 5 - Western",2586,94
Jeff Davis,Election Day,1906,"Public Service Commission, District 5 - Western",1810,96
Jeff Davis,Provisional,0,"Public Service Commission, District 5 - Western",0,0
Jefferson,Absentee by Mail,607,"Public Service Commission, District 5 - Western",591,16
Jefferson,Advance in Person,2803,"Public Service Commission, District 5 - Western",2691,112
Jefferson,Election Day,3346,"Public Service Commission, District 5 - Western",3202,144
Jefferson,Provisional,11,"Public Service Commission, District 5 - Western",11,0
Jenkins,Absentee by Mail,188,"Public Service Commission, District 5 - Western",181,7
Jenkins,Advance in Person,1557,"Public Service Commission, District 5 - Western",1508,49
Jenkins,Election Day,1111,"Public Service Commission, District 5 - Western",1082,29
Jenkins,Provisional,16,"Public Service Commission, District 5 - Western",16,0
Johnson,Absentee by Mail,236,"Public Service Commission, District 5 - Western",223,13
Johnson,Advance in Person,1970,"Public Service Commission, District 5 - Western",1906,64
Johnson,Election Day,1277,"Public Service Commission, District 5 - Western",1208,69
Johnson,Provisional,0,"Public Service Commission, District 5 - Western",0,0
Jones,Absentee by Mail,784,"Public Service Commission, District 5 - Western",760,24
Jones,Advance in Person,6968,"Public Service Commission, District 5 - Western",6839,129
Jones,Election Day,4680,"Public Service Commission, District 5 - Western",4569,111
Jones,Provisional,9,"Public Service Commission, District 5 - Western",9,0
Lamar,Absentee by Mail,404,"Public Service Commission, District 5 - Western",392,12
Lamar,Advance in Person,3820,"Public Service Commission, District 5 - Western",3745,75
Lamar,Election Day,3122,"Public Service Commission, District 5 - Western",3056,66
Lamar,Provisional,11,"Public Service Commission, District 5 - Western",11,0
Lanier,Absentee by Mail,108,"Public Service Commission, District 5 - Western",104,4
Lanier,Advance in Person,1661,"Public Service Commission, District 5 - Western",1610,51
Lanier,Election Day,910,"Public Service Commission, District 5 - Western",861,49
Lanier,Provisional,2,"Public Service Commission, District 5 - Western",2,0
Laurens,Absentee by Mail,1286,"Public Service Commission, District 5 - Western",1242,44
Laurens,Advance in Person,8485,"Public Service Commission, District 5 - Western",8250,235
Laurens,Election Day,9168,"Public Service Commission, District 5 - Western",8873,295
Laurens,Provisional,13,"Public Service Commission, District 5 - Western",13,0
Lee,Absentee by Mail,480,"Public Service Commission, District 5 - Western",472,8
Lee,Advance in Person,5681,"Public Service Commission, District 5 - Western",5598,83
Lee,Election Day,7388,"Public Service Commission, District 5 - Western",7262,126
Lee,Provisional,6,"Public Service Commission, District 5 - Western",6,0
Liberty,Absentee by Mail,950,"Public Service Commission, District 5 - Western",936,14
Liberty,Advance in Person,8143,"Public Service Commission, District 5 - Western",8017,126
Liberty,Election Day,6265,"Public Service Commission, District 5 - Western",6148,117
Liberty,Provisional,10,"Public Service Commission, District 5 - Western",9,1
Lincoln,Absentee by Mail,350,"Public Service Commission, District 5 - Western",346,4
Lincoln,Advance in Person,1937,"Public Service Commission, District 5 - Western",1898,39
Lincoln,Election Day,1680,"Public Service Commission, District 5 - Western",1626,54
Lincoln,Provisional,2,"Public Service Commission, District 5 - Western",2,0
Long,Absentee by Mail,169,"Public Service Commission, District 5 - Western",167,2
Long,Advance in Person,1971,"Public Service Commission, District 5 - Western",1908,63
Long,Election Day,1848,"Public Service Commission, District 5 - Western",1782,66
Long,Provisional,10,"Public Service Commission, District 5 - Western",10,0
Lowndes,Absentee by Mail,1890,"Public Service Commission, District 5 - Western",1849,41
Lowndes,Advance in Person,21238,"Public Service Commission, District 5 - Western",20919,319
Lowndes,Election Day,12084,"Public Service Commission, District 5 - Western",11822,262
Lowndes,Provisional,541,"Public Service Commission, District 5 - Western",521,20
Lumpkin,Absentee by Mail,467,"Public Service Commission, District 5 - Western",456,11
Lumpkin,Advance in Person,7377,"Public Service Commission, District 5 - Western",7237,140
Lumpkin,Election Day,3707,"Public Service Commission, District 5 - Western",3609,98
Lumpkin,Provisional,7,"Public Service Commission, District 5 - Western",7,0
Macon,Absentee by Mail,331,"Public Service Commission, District 5 - Western",318,13
Macon,Advance in Person,2251,"Public Service Commission, District 5 - Western",2142,109
Macon,Election Day,1635,"Public Service Commission, District 5 - Western",1561,74
Macon,Provisional,0,"Public Service Commission, District 5 - Western",0,0
Madison,Absentee by Mail,527,"Public Service Commission, District 5 - Western",517,10
Madison,Advance in Person,5242,"Public Service Commission, District 5 - Western",5111,131
Madison,Election Day,5928,"Public Service Commission, District 5 - Western",5775,153
Madison,Provisional,2,"Public Service Commission, District 5 - Western",2,0
Marion,Absentee by Mail,241,"Public Service Commission, District 5 - Western",239,2
Marion,Advance in Person,1222,"Public Service Commission, District 5 - Western",1175,47
Marion,Election Day,1467,"Public Service Commission, District 5 - Western",1423,44
Marion,Provisional,1,"Public Service Commission, District 5 - Western",1,0
McDuffie,Absentee by Mail,868,"Public Service Commission, District 5 - Western",855,13
McDuffie,Advance in Person,5045,"Public Service Commission, District 5 - Western",4953,92
McDuffie,Election Day,2879,"Public Service Commission, District 5 - Western",2812,67
McDuffie,Provisional,0,"Public Service Commission, District 5 - Western",0,0
McIntosh,Absentee by Mail,440,"Public Service Commission, District 5 - Western",431,9
McIntosh,Advance in Person,2945,"Public Service Commission, District 5 - Western",2870,75
McIntosh,Election Day,2023,"Public Service Commission, District 5 - Western",1952,71
McIntosh,Provisional,0,"Public Service Commission, District 5 - Western",0,0
Meriwether,Absentee by Mail,483,"Public Service Commission, District 5 - Western",471,12
Meriwether,Advance in Person,2831,"Public Service Commission, District 5 - Western",2768,63
Meriwether,Election Day,5325,"Public Service Commission, District 5 - Western",5181,144
Meriwether,Provisional,11,"Public Service Commission, District 5 - Western",10,1
Miller,Absentee by Mail,132,"Public Service Commission, District 5 - Western",126,6
Miller,Advance in Person,1029,"Public Service Commission, District 5 - Western",981,48
Miller,Election Day,1152,"Public Service Commission, District 5 - Western",1097,55
Miller,Provisional,2,"Public Service Commission, District 5 - Western",2,0
Mitchell,Absentee by Mail,564,"Public Service Commission, District 5 - Western",559,5
Mitchell,Advance in Person,3343,"Public Service Commission, District 5 - Western",3278,65
Mitchell,Election Day,3539,"Public Service Commission, District 5 - Western",3453,86
Mitchell,Provisional,9,"Public Service Commission, District 5 - Western",9,0
Monroe,Absentee by Mail,696,"Public Service Commission, District 5 - Western",686,10
Monroe,Advance in Person,6311,"Public Service Commission, District 5 - Western",6172,139
Monroe,Election Day,5925,"Public Service Commission, District 5 - Western",5781,144
Monroe,Provisional,10,"Public Service Commission, District 5 - Western",10,0
Montgomery,Absentee by Mail,211,"Public Service Commission, District 5 - Western",205,6
Montgomery,Advance in Person,1416,"Public Service Commission, District 5 - Western",1360,56
Montgomery,Election Day,1901,"Public Service Commission, District 5 - Western",1823,78
Montgomery,Provisional,0,"Public Service Commission, District 5 - Western",0,0
Morgan,Absentee by Mail,410,"Public Service Commission, District 5 - Western",394,16
Morgan,Advance in Person,5406,"Public Service Commission, District 5 - Western",5301,105
Morgan,Election Day,3738,"Public Service Commission, District 5 - Western",3639,99
Morgan,Provisional,4,"Public Service Commission, District 5 - Western",4,0
Murray,Absentee by Mail,265,"Public Service Commission, District 5 - Western",254,11
Murray,Advance in Person,5111,"Public Service Commission, District 5 - Western",4950,161
Murray,Election Day,5715,"Public Service Commission, District 5 - Western",5552,163
Murray,Provisional,0,"Public Service Commission, District 5 - Western",0,0
Muscogee,Absentee by Mail,4422,"Public Service Commission, District 5 - Western",4336,86
Muscogee,Advance in Person,27700,"Public Service Commission, District 5 - Western",27205,495
Muscogee,Election Day,31019,"Public Service Commission, District 5 - Western",30326,693
Muscogee,Provisional,131,"Public Service Commission, District 5 - Western",124,7
Newton,Absentee by Mail,2735,"Public Service Commission, District 5 - Western",2692,43
Newton,Advance in Person,19236,"Public Service Commission, District 5 - Western",18885,351
Newton,Election Day,21158,"Public Service Commission, District 5 - Western",20752,406
Newton,Provisional,12,"Public Service Commission, District 5 - Western",11,1
Oconee,Absentee by Mail,931,"Public Service Commission, District 5 - Western",902,29
Oconee,Advance in Person,11688,"Public Service Commission, District 5 - Western",11482,206
Oconee,Election Day,8114,"Public Service Commission, District 5 - Western",7873,241
Oconee,Provisional,11,"Public Service Commission, District 5 - Western",11,0
Oglethorpe,Absentee by Mail,409,"Public Service Commission, District 5 - Western",400,9
Oglethorpe,Advance in Person,3417,"Public Service Commission, District 5 - Western",3342,75
Oglethorpe,Election Day,2658,"Public Service Commission, District 5 - Western",2570,88
Oglethorpe,Provisional,1,"Public Service Commission, District 5 - Western",1,0
Paulding,Absentee by Mail,3307,"Public Service Commission, District 5 - Western",3240,67
Paulding,Advance in Person,32842,"Public Service Commission, District 5 - Western",32364,478
Paulding,Election Day,25073,"Public Service Commission, District 5 - Western",24624,449
Paulding,Provisional,83,"Public Service Commission, District 5 - Western",79,4
Peach,Absentee by Mail,445,"Public Service Commission, District 5 - Western",434,11
Peach,Advance in Person,6720,"Public Service Commission, District 5 - Western",6573,147
Peach,Election Day,3190,"Public Service Commission, District 5 - Western",3119,71
Peach,Provisional,90,"Public Service Commission, District 5 - Western",85,5
Pickens,Absentee by Mail,222,"Public Service Commission, District 5 - Western",215,7
Pickens,Advance in Person,7121,"Public Service Commission, District 5 - Western",6972,149
Pickens,Election Day,6019,"Public Service Commission, District 5 - Western",5852,167
Pickens,Provisional,0,"Public Service Commission, District 5 - Western",0,0
Pierce,Absentee by Mail,327,"Public Service Commission, District 5 - Western",325,2
Pierce,Advance in Person,4598,"Public Service Commission, District 5 - Western",4522,76
Pierce,Election Day,1958,"Public Service Commission, District 5 - Western",1921,37
Pierce,Provisional,1,"Public Service Commission, District 5 - Western",1,0
Pike,Absentee by Mail,304,"Public Service Commission, District 5 - Western",299,5
Pike,Advance in Person,4478,"Public Service Commission, District 5 - Western",4420,58
Pike,Election Day,3752,"Public Service Commission, District 5 - Western",3670,82
Pike,Provisional,9,"Public Service Commission, District 5 - Western",9,0
Polk,Absentee by Mail,447,"Public Service Commission, District 5 - Western",443,4
Polk,Advance in Person,7744,"Public Service Commission, District 5 - Western",7590,154
Polk,Election Day,4668,"Public Service Commission, District 5 - Western",4527,141
Polk,Provisional,2,"Public Service Commission, District 5 - Western",2,0
Pulaski,Absentee by Mail,232,"Public Service Commission, District 5 - Western",220,12
Pulaski,Advance in Person,2522,"Public Service Commission, District 5 - Western",2422,100
Pulaski,Election Day,868,"Public Service Commission, District 5 - Western",824,44
Pulaski,Provisional,0,"Public Service Commission, District 5 - Western",0,0
Putnam,Absentee by Mail,598,"Public Service Commission, District 5 - Western",591,7
Putnam,Advance in Person,4858,"Public Service Commission, District 5 - Western",4774,84
Putnam,Election Day,3865,"Public Service Commission, District 5 - Western",3772,93
Putnam,Provisional,14,"Public Service Commission, District 5 - Western",14,0
Quitman,Absentee by Mail,60,"Public Service Commission, District 5 - Western",51,9
Quitman,Advance in Person,451,"Public Service Commission, District 5 - Western",423,28
Quitman,Election Day,429,"Public Service Commission, District 5 - Western",410,19
Quitman,Provisional,0,"Public Service Commission, District 5 - Western",0,0
Rabun,Absentee by Mail,843,"Public Service Commission, District 5 - Western",819,24
Rabun,Advance in Person,4889,"Public Service Commission, District 5 - Western",4773,116
Rabun,Election Day,1846,"Public Service Commission, District 5 - Western",1790,56
Rabun,Provisional,0,"Public Service Commission, District 5 - Western",0,0
Randolph,Absentee by Mail,313,"Public Service Commission, District 5 - Western",307,6
Randolph,Advance in Person,1232,"Public Service Commission, District 5 - Western",1187,45
Randolph,Election Day,1243,"Public Service Commission, District 5 - Western",1201,42
Randolph,Provisional,1,"Public Service Commission, District 5 - Western",1,0
Richmond,Absentee by Mail,5314,"Public Service Commission, District 5 - Western",5204,110
Richmond,Advance in Person,28737,"Public Service Commission, District 5 - Western",28222,515
Richmond,Election Day,35992,"Public Service Commission, District 5 - Western",35121,871
Richmond,Provisional,112,"Public Service Commission, District 5 - Western",108,4
Rockdale,Absentee by Mail,1853,"Public Service Commission, District 5 - Western",1824,29
Rockdale,Advance in Person,22789,"Public Service Commission, District 5 - Western",22480,309
Rockdale,Election Day,11958,"Public Service Commission, District 5 - Western",11747,211
Rockdale,Provisional,55,"Public Service Commission, District 5 - Western",52,3
Schley,Absentee by Mail,96,"Public Service Commission, District 5 - Western",96,0
Schley,Advance in Person,1321,"Public Service Commission, District 5 - Western",1284,37
Schley,Election Day,514,"Public Service Commission, District 5 - Western",492,22
Schley,Provisional,2,"Public Service Commission, District 5 - Western",2,0
Screven,Absentee by Mail,271,"Public Service Commission, District 5 - Western",265,6
Screven,Advance in Person,2674,"Public Service Commission, District 5 - Western",2573,101
Screven,Election Day,2462,"Public Service Commission, District 5 - Western",2374,88
Screven,Provisional,7,"Public Service Commission, District 5 - Western",7,0
Seminole,Absentee by Mail,264,"Public Service Commission, District 5 - Western",256,8
Seminole,Advance in Person,1078,"Public Service Commission, District 5 - Western",1060,18
Seminole,Election Day,1872,"Public Service Commission, District 5 - Western",1823,49
Seminole,Provisional,13,"Public Service Commission, District 5 - Western",12,1
Spalding,Absentee by Mail,1283,"Public Service Commission, District 5 - Western",1237,46
Spalding,Advance in Person,13046,"Public Service Commission, District 5 - Western",12691,355
Spalding,Election Day,10056,"Public Service Commission, District 5 - Western",9813,243
Spalding,Provisional,32,"Public Service Commission, District 5 - Western",26,6
Stephens,Absentee by Mail,536,"Public Service Commission, District 5 - Western",522,14
Stephens,Advance in Person,6139,"Public Service Commission, District 5 - Western",6022,117
Stephens,Election Day,2394,"Public Service Commission, District 5 - Western",2321,73
Stephens,Provisional,18,"Public Service Commission, District 5 - Western",17,1
Stewart,Absentee by Mail,233,"Public Service Commission, District 5 - Western",222,11
Stewart,Advance in Person,694,"Public Service Commission, District 5 - Western",646,48
Stewart,Election Day,857,"Public Service Commission, District 5 - Western",770,87
Stewart,Provisional,35,"Public Service Commission, District 5 - Western",35,0
Sumter,Absentee by Mail,877,"Public Service Commission, District 5 - Western",855,22
Sumter,Advance in Person,5531,"Public Service Commission, District 5 - Western",5393,138
Sumter,Election Day,4148,"Public Service Commission, District 5 - Western",4019,129
Sumter,Provisional,0,"Public Service Commission, District 5 - Western",0,0
Talbot,Absentee by Mail,285,"Public Service Commission, District 5 - Western",262,23
Talbot,Advance in Person,772,"Public Service Commission, District 5 - Western",747,25
Talbot,Election Day,1895,"Public Service Commission, District 5 - Western",1794,101
Talbot,Provisional,2,"Public Service Commission, District 5 - Western",2,0
Taliaferro,Absentee by Mail,162,"Public Service Commission, District 5 - Western",147,15
Taliaferro,Advance in Person,441,"Public Service Commission, District 5 - Western",400,41
Taliaferro,Election Day,314,"Public Service Commission, District 5 - Western",288,26
Taliaferro,Provisional,4,"Public Service Commission, District 5 - Western",4,0
Tattnall,Absentee by Mail,392,"Public Service Commission, District 5 - Western",383,9
Tattnall,Advance in Person,3539,"Public Service Commission, District 5 - Western",3417,122
Tattnall,Election Day,2708,"Public Service Commission, District 5 - Western",2606,102
Tattnall,Provisional,8,"Public Service Commission, District 5 - Western",8,0
Taylor,Absentee by Mail,243,"Public Service Commission, District 5 - Western",238,5
Taylor,Advance in Person,1843,"Public Service Commission, District 5 - Western",1801,42
Taylor,Election Day,1179,"Public Service Commission, District 5 - Western",1130,49
Taylor,Provisional,29,"Public Service Commission, District 5 - Western",29,0
Telfair,Absentee by Mail,331,"Public Service Commission, District 5 - Western",325,6
Telfair,Advance in Person,1676,"Public Service Commission, District 5 - Western",1590,86
Telfair,Election Day,1624,"Public Service Commission, District 5 - Western",1562,62
Telfair,Provisional,1,"Public Service Commission, District 5 - Western",1,0
Terrell,Absentee by Mail,327,"Public Service Commission, District 5 - Western",323,4
Terrell,Advance in Person,1612,"Public Service Commission, District 5 - Western",1566,46
Terrell,Election Day,1991,"Public Service Commission, District 5 - Western",1914,77
Terrell,Provisional,9,"Public Service Commission, District 5 - Western",9,0
Thomas,Absentee by Mail,991,"Public Service Commission, District 5 - Western",975,16
Thomas,Advance in Person,8376,"Public Service Commission, District 5 - Western",8200,176
Thomas,Election Day,7874,"Public Service Commission, District 5 - Western",7673,201
Thomas,Provisional,3,"Public Service Commission, District 5 - Western",3,0
Tift,Absentee by Mail,561,"Public Service Commission, District 5 - Western",552,9
Tift,Advance in Person,7646,"Public Service Commission, District 5 - Western",7439,207
Tift,Election Day,5462,"Public Service Commission, District 5 - Western",5285,177
Tift,Provisional,4,"Public Service Commission, District 5 - Western",3,1
Toombs,Absentee by Mail,681,"Public Service Commission, District 5 - Western",663,18
Toombs,Advance in Person,4860,"Public Service Commission, District 5 - Western",4738,122
Toombs,Election Day,3310,"Public Service Commission, District 5 - Western",3217,93
Toombs,Provisional,9,"Public Service Commission, District 5 - Western",9,0
Towns,Absentee by Mail,284,"Public Service Commission, District 5 - Western",277,7
Towns,Advance in Person,4009,"Public Service Commission, District 5 - Western",3888,121
Towns,Election Day,1839,"Public Service Commission, District 5 - Western",1797,42
Towns,Provisional,0,"Public Service Commission, District 5 - Western",0,0
Treutlen,Absentee by Mail,146,"Public Service Commission, District 5 - Western",138,8
Treutlen,Advance in Person,1659,"Public Service Commission, District 5 - Western",1590,69
Treutlen,Election Day,805,"Public Service Commission, District 5 - Western",768,37
Treutlen,Provisional,4,"Public Service Commission, District 5 - Western",4,0
Troup,Absentee by Mail,1264,"Public Service Commission, District 5 - Western",1230,34
Troup,Advance in Person,11226,"Public Service Commission, District 5 - Western",11039,187
Troup,Election Day,11173,"Public Service Commission, District 5 - Western",10909,264
Troup,Provisional,250,"Public Service Commission, District 5 - Western",243,7
Turner,Absentee by Mail,148,"Public Service Commission, District 5 - Western",147,1
Turner,Advance in Person,1922,"Public Service Commission, District 5 - Western",1850,72
Turner,Election Day,1199,"Public Service Commission, District 5 - Western",1162,37
Turner,Provisional,5,"Public Service Commission, District 5 - Western",5,0
Twiggs,Absentee by Mail,275,"Public Service Commission, District 5 - Western",268,7
Twiggs,Advance in Person,1531,"Public Service Commission, District 5 - Western",1481,50
Twiggs,Election Day,1981,"Public Service Commission, District 5 - Western",1903,78
Twiggs,Provisional,5,"Public Service Commission, District 5 - Western",5,0
Union,Absentee by Mail,482,"Public Service Commission, District 5 - Western",468,14
Union,Advance in Person,6626,"Public Service Commission, District 5 - Western",6505,121
Union,Election Day,4755,"Public Service Commission, District 5 - Western",4597,158
Union,Provisional,2,"Public Service Commission, District 5 - Western",2,0
Upson,Absentee by Mail,602,"Public Service Commission, District 5 - Western",590,12
Upson,Advance in Person,6729,"Public Service Commission, District 5 - Western",6566,163
Upson,Election Day,3227,"Public Service Commission, District 5 - Western",3147,80
Upson,Provisional,10,"Public Service Commission, District 5 - Western",9,1
Walker,Absentee by Mail,813,"Public Service Commission, District 5 - Western",794,19
Walker,Advance in Person,11133,"Public Service Commission, District 5 - Western",10910,223
Walker,Election Day,9505,"Public Service Commission, District 5 - Western",9262,243
Walker,Provisional,39,"Public Service Commission, District 5 - Western",37,2
Walton,Absentee by Mail,1769,"Public Service Commission, District 5 - Western",1734,35
Walton,Advance in Person,14370,"Public Service Commission, District 5 - Western",14116,254
Walton,Election Day,22496,"Public Service Commission, District 5 - Western",22084,412
Walton,Provisional,51,"Public Service Commission, District 5 - Western",49,2
Ware,Absentee by Mail,627,"Public Service Commission, District 5 - Western",612,15
Ware,Advance in Person,5460,"Public Service Commission, District 5 - Western",5379,81
Ware,Election Day,4917,"Public Service Commission, District 5 - Western",4804,113
Ware,Provisional,12,"Public Service Commission, District 5 - Western",12,0
Warren,Absentee by Mail,187,"Public Service Commission, District 5 - Western",184,3
Warren,Advance in Person,1267,"Public Service Commission, District 5 - Western",1218,49
Warren,Election Day,806,"Public Service Commission, District 5 - Western",777,29
Warren,Provisional,1,"Public Service Commission, District 5 - Western",1,0
Washington,Absentee by Mail,727,"Public Service Commission, District 5 - Western",701,26
Washington,Advance in Person,3907,"Public Service Commission, District 5 - Western",3762,145
Washington,Election Day,3525,"Public Service Commission, District 5 - Western",3333,192
Washington,Provisional,10,"Public Service Commission, District 5 - Western",10,0
Wayne,Absentee by Mail,501,"Public Service Commission, District 5 - Western",489,12
Wayne,Advance in Person,5868,"Public Service Commission, District 5 - Western",5719,149
Wayne,Election Day,3753,"Public Service Commission, District 5 - Western",3653,100
Wayne,Provisional,10,"Public Service Commission, District 5 - Western",8,2
Webster,Absentee by Mail,152,"Public Service Commission, District 5 - Western",147,5
Webster,Advance in Person,544,"Public Service Commission, District 5 - Western",527,17
Webster,Election Day,404,"Public Service Commission, District 5 - Western",384,20
Webster,Provisional,0,"Public Service Commission, District 5 - Western",0,0
Wheeler,Absentee by Mail,115,"Public Service Commission, District 5 - Western",112,3
Wheeler,Advance in Person,974,"Public Service Commission, District 5 - Western",943,31
Wheeler,Election Day,838,"Public Service Commission, District 5 - Western",807,31
Wheeler,Provisional,4,"Public Service Commission, District 5 - Western",3,1
White,Absentee by Mail,537,"Public Service Commission, District 5 - Western",527,10
White,Advance in Person,5408,"Public Service Commission, District 5 - Western",5318,90
White,Election Day,5489,"Public Service Commission, District 5 - Western",5391,98
White,Provisional,6,"Public Service Commission, District 5 - Western",6,0
Whitfield,Absentee by Mail,1017,"Public Service Commission, District 5 - Western",1000,17
Whitfield,Advance in Person,9610,"Public Service Commission, District 5 - Western",9400,210
Whitfield,Election Day,16675,"Public Service Commission, District 5 - Western",16197,478
Whitfield,Provisional,25,"Public Service Commission, District 5 - Western",24,1
Wilcox,Absentee by Mail,205,"Public Service Commission, District 5 - Western",199,6
Wilcox,Advance in Person,1202,"Public Service Commission, District 5 - Western",1174,28
Wilcox,Election Day,1408,"Public Service Commission, District 5 - Western",1362,46
Wilcox,Provisional,0,"Public Service Commission, District 5 - Western",0,0
Wilkes,Absentee by Mail,301,"Public Service Commission, District 5 - Western",288,13
Wilkes,Advance in Person,2075,"Public Service Commission, District 5 - Western",1997,78
Wilkes,Election Day,1995,"Public Service Commission, District 5 - Western",1923,72
Wilkes,Provisional,6,"Public Service Commission, District 5 - Western",6,0
Wilkinson,Absentee by Mail,270,"Public Service Commission, District 5 - Western",263,7
Wilkinson,Advance in Person,1567,"Public Service Commission, District 5 - Western",1511,56
Wilkinson,Election Day,2427,"Public Service Commission, District 5 - Western",2315,112
Wilkinson,Provisional,1,"Public Service Commission, District 5 - Western",1,0
Worth,Absentee by Mail,305,"Public Service Commission, District 5 - Western",299,6
Worth,Advance in Person,3108,"Public Service Commission, District 5 - Western",3046,62
Worth,Election Day,4418,"Public Service Commission, District 5 - Western",4288,130
Worth,Provisional,15,"Public Service Commission, District 5 - Western",15,0
